Year,CoC_Number,CoC_Name,Overall_Homeless,Chronic_Homeless,Non-Chronic_Homeless,Actual_CoC_Median_Rent,Previous_CoC_Neighbor_Median_Rent
2022,AK-500,Anchorage CoC,1494,474,1020,938.0,780.0
2022,AK-501,Alaska Balance of State CoC,826,125,701,788.0,937.0
2022,AL-500,"Birmingham/Jefferson, St. Clair, Shelby Counties CoC",943,267,676,834.0,728.2777777777778
2022,AL-501,Mobile City & County/Baldwin County CoC,585,76,509,783.45,635.85
2022,AL-502,Florence/Northwest Alabama CoC,232,11,221,553.9,550.6
2022,AL-503,Huntsville/North Alabama CoC,549,118,431,681.9166666666666,533.5833333333334
2022,AL-504,Montgomery City & County CoC,278,57,221,674.4375,539.375
2022,AL-506,Tuscaloosa City & County CoC,40,0,40,814.0,750.4166666666667
2022,AL-507,Alabama Balance of State CoC,935,22,913,596.6744720965308,692.7245286576169
2022,AR-500,Little Rock/Central Arkansas CoC,859,290,569,692.0,598.35
2022,AR-501,Fayetteville/Northwest Arkansas CoC,343,49,294,616.1333333333333,527.3944444444445
2022,AR-503,Arkansas  Balance of State  CoC,814,111,703,553.1956862745099,596.5353921568628
2022,AR-505,Southeast Arkansas CoC,69,0,69,544.5442857142857,592.8809523809523
2022,AZ-500,Arizona Balance of State CoC,2300,600,1700,748.3683333333333,789.6208333333333
2022,AZ-501,Tucson/Pima County CoC,2227,798,1429,708.0,877.4
2022,AZ-502,"Phoenix, Mesa/Maricopa County CoC",9026,1287,7739,1086.0,726.8
2022,CA-500,San Jose/Santa Clara City & County CoC,10028,2838,7190,2362.0,1551.0
2022,CA-501,San Francisco CoC,7754,2691,5063,2317.0,2107.5
2022,CA-502,"Oakland, Berkeley/Alameda County CoC",9747,2728,7019,1689.0,1811.1666666666667
2022,CA-503,Sacramento City & County CoC,9278,4314,4964,1189.0,1162.0
2022,CA-504,"Santa Rosa, Petaluma/Sonoma County CoC",2893,725,2168,1492.0,1450.1666666666667
2022,CA-505,Richmond/Contra Costa County CoC,3093,1567,1526,1689.0,1638.7142857142858
2022,CA-506,"Salinas/Monterey, San Benito Counties CoC",2404,745,1659,1438.5,1375.1666666666667
2022,CA-507,Marin County CoC,1121,284,837,2317.0,1744.25
2022,CA-508,Watsonville/Santa Cruz City & County CoC,2299,921,1378,2155.0,2063.0
2022,CA-509,Mendocino County CoC,830,177,653,1003.0,878.5
2022,CA-510,"Turlock, Modesto/Stanislaus County CoC",1857,493,1364,999.0,1318.3333333333335
2022,CA-511,Stockton/San Joaquin County CoC,2319,809,1510,964.0,1291.4
2022,CA-512,Daly/San Mateo County CoC,1808,705,1103,2317.0,2157.5
2022,CA-513,"Visalia/Kings, Tulare Counties CoC",1235,317,918,905.6,1048.2
2022,CA-514,Fresno City & County/Madera County CoC,4216,938,3278,960.3,947.0333333333334
2022,CA-515,"Roseville, Rocklin/Placer County CoC",750,256,494,1189.0,961.0833333333334
2022,CA-516,"Redding/Shasta, Siskiyou, Lassen, Plumas, Del Norte, Modoc, Sierra Counties CoC",1837,574,1263,734.2777777777778,802.9259259259259
2022,CA-517,Napa City & County CoC,495,132,363,1554.0,1176.5
2022,CA-518,Vallejo/Solano County CoC,1179,195,984,1352.0,1575.3333333333333
2022,CA-519,"Chico, Paradise/Butte County CoC",1006,326,680,887.0,753.75
2022,CA-520,Merced City & County CoC,855,217,638,824.0,1258.4
2022,CA-521,"Davis, Woodland/Yolo County CoC",746,341,405,1320.0,1048.0
2022,CA-522,Humboldt County CoC,1648,746,902,798.0,765.5
2022,CA-523,"Colusa, Glenn, Trinity Counties CoC",340,57,283,688.0,879.3125
2022,CA-524,Yuba City & County/Sutter County CoC,1094,297,797,986.0,970.4285714285714
2022,CA-525,El Dorado County CoC,511,100,411,1189.0,955.4
2022,CA-526,"Amador, Calaveras, Mariposa, Tuolumne Counties CoC",625,238,387,857.9880952380952,950.6428571428571
2022,CA-600,Los Angeles City & County CoC,65111,26985,38126,1527.0,1253.25
2022,CA-601,San Diego City and County CoC,8427,1414,7013,1714.0,1194.6666666666667
2022,CA-602,"Santa Ana, Anaheim/Orange County CoC",5718,2463,3255,1844.0,1281.75
2022,CA-603,Santa Maria/Santa Barbara County CoC,1962,565,1397,1986.0,1143.3333333333333
2022,CA-604,Bakersfield/Kern County CoC,1603,345,1258,816.0,1253.7857142857142
2022,CA-608,Riverside City & County CoC,3316,816,2500,1153.0,1171.2
2022,CA-609,San Bernardino City & County CoC,3333,1115,2218,1153.0,1074.642857142857
2022,CA-611,"Oxnard, San Buenaventura/Ventura County CoC",2248,638,1610,1647.0,1380.3333333333333
2022,CA-613,Imperial County CoC,1057,541,516,757.0,1103.6666666666667
2022,CA-614,San Luis Obispo County CoC,1448,282,1166,1421.0,1268.25
2022,CO-500,Colorado Balance of State CoC,1315,485,830,825.7757031857033,739.8110062160061
2022,CO-503,Metropolitan Denver CoC,6884,2573,4311,1352.9871794871794,933.1089743589743
2022,CO-504,Colorado Springs/El Paso County CoC,1406,396,1010,956.0,1058.3
2022,CT-503,"Bridgeport, Stamford, Norwalk, Danbury/Fairfield County CoC",603,12,591,1322.2608695652175,1385.0
2022,CT-505,Connecticut Balance of State CoC,2327,105,2222,913.7925925925928,1064.9489130434781
2022,DE-500,Delaware Statewide CoC,2369,223,2146,924.0714285714286,925.3809523809523
2022,FL-500,"Sarasota, Bradenton/Manatee, Sarasota Counties CoC",1138,255,883,996.0,853.1666666666666
2022,FL-501,Tampa/Hillsborough County CoC,1513,114,1399,1125.0,900.2
2022,FL-502,"St. Petersburg, Clearwater, Largo/Pinellas County CoC",1985,483,1502,1125.0,1070.0
2022,FL-503,"Lakeland, Winterhaven/Polk County CoC",506,57,449,900.0,962.6666666666666
2022,FL-504,"Deltona, Daytona Beach/Volusia, Flagler Counties CoC",865,73,792,822.0,878.0
2022,FL-505,"Fort Walton Beach/Okaloosa, Walton Counties CoC",403,85,318,968.5,632.6666666666666
2022,FL-506,Tallahassee/Leon County CoC,621,153,468,744.6018518518518,636.037037037037
2022,FL-507,"Orlando/Orange, Osceola, Seminole Counties CoC",2151,403,1748,1239.0,820.25
2022,FL-508,"Gainesville/Alachua, Putnam Counties CoC",925,223,702,669.1388888888889,746.6666666666666
2022,FL-509,"Fort Pierce/St. Lucie, Indian River, Martin Counties CoC",846,48,798,910.0,925.25
2022,FL-510,"Jacksonville-Duval, Clay Counties CoC",1279,117,1162,895.0,700.6666666666666
2022,FL-511,"Pensacola/Escambia, Santa Rosa Counties CoC",727,250,477,908.0,789.3333333333334
2022,FL-512,St. Johns County CoC,349,80,269,895.0,749.0
2022,FL-513,"Palm Bay, Melbourne/Brevard County CoC",916,290,626,866.0,868.0
2022,FL-514,Ocala/Marion County CoC,455,63,392,792.0,763.6666666666666
2022,FL-515,"Panama City/Bay, Jackson Counties CoC",378,71,307,624.5416666666667,673.9166666666666
2022,FL-517,"Hendry, Hardee, Highlands Counties CoC",650,12,638,700.38,997.68
2022,FL-518,"Columbia, Hamilton, Lafayette, Suwannee Counties CoC",488,37,451,667.6333333333333,702.4666666666667
2022,FL-519,Pasco County CoC,589,126,463,1125.0,977.625
2022,FL-520,"Citrus, Hernando, Lake, Sumter Counties CoC",745,50,695,1026.1666666666667,850.1666666666666
2022,FL-600,Miami-Dade County CoC,3276,762,2514,1260.0,1199.0
2022,FL-601,Ft Lauderdale/Broward County CoC,2054,388,1666,1207.0,984.0
2022,FL-602,Punta Gorda/Charlotte County CoC,148,0,148,886.0,864.3333333333334
2022,FL-603,"Ft Myers, Cape Coral/Lee County CoC",560,47,513,1061.0,859.1666666666666
2022,FL-604,Monroe County CoC,526,35,491,1485.0,1081.0
2022,FL-605,West Palm Beach/Palm Beach County CoC,1404,248,1156,1144.0,946.8888888888888
2022,FL-606,Naples/Collier County CoC,462,39,423,1189.0,1087.4
2022,GA-500,Atlanta CoC,2017,495,1522,1205.0,1101.0
2022,GA-501,Georgia Balance of State CoC,5856,557,5299,793.1059015763168,741.7817377931564
2022,GA-503,Athens-Clarke County CoC,283,49,234,784.0,765.2
2022,GA-504,Augusta-Richmond County CoC,549,71,478,741.0,672.25
2022,GA-505,Columbus-Muscogee CoC,243,47,196,703.0,650.8333333333333
2022,GA-506,Marietta/Cobb County CoC,380,25,355,1205.0,1101.0
2022,GA-507,Savannah/Chatham County CoC,523,103,420,954.0,892.6666666666667
2022,GA-508,DeKalb County CoC,565,84,481,1205.0,1101.0
2022,IA-500,"Sioux City/Dakota, Woodbury Counties CoC",212,51,161,613.0,538.5
2022,IA-501,Iowa Balance of State CoC,1601,224,1377,578.8844932844933,576.4537795537796
2022,IA-502,Des Moines/Polk County CoC,606,166,440,698.0,638.8571428571429
2022,ID-500,Boise/Ada County CoC,620,118,502,827.0,686.8
2022,ID-501,Idaho Balance of State CoC,1378,192,1186,683.6979166666667,685.0819444444444
2022,IL-500,McHenry County CoC,92,4,88,1150.0,930.6
2022,IL-501,"Rockford/DeKalb, Winnebago, Boone Counties CoC",406,21,385,686.6,900.9
2022,IL-502,"Waukegan, North Chicago/Lake County CoC",431,65,366,1150.0,904.25
2022,IL-503,"Champaign, Urbana, Rantoul/Champaign County CoC",137,16,121,879.0,612.5
2022,IL-506,"Joliet, Bolingbrook/Will County CoC",219,20,199,1099.1666666666667,846.7142857142857
2022,IL-507,"Peoria, Pekin/Fulton, Tazewell, Peoria, Woodford Counties CoC",337,65,272,616.0,565.7777777777778
2022,IL-511,Cook County CoC,1096,242,854,1150.0,974.7142857142857
2022,IL-512,Bloomington/Central Illinois CoC,241,40,201,636.2103174603175,650.3452380952382
2022,IL-513,Springfield/Sangamon County CoC,264,51,213,593.0,533.4583333333334
2022,IL-514,DuPage County CoC,555,61,494,1150.0,1100.8333333333333
2022,IL-515,South Central Illinois CoC,157,3,154,590.201851851852,609.1913580246913
2022,IL-516,Decatur/Macon County CoC,93,15,78,575.0,572.1111111111111
2022,IL-517,"Aurora, Elgin/Kane County CoC",391,92,299,1150.0,1029.0
2022,IL-518,"Rock Island, Moline/Northwestern Illinois CoC",280,41,239,604.7823129251701,634.4574829931972
2022,IL-519,West Central Illinois CoC,97,0,97,527.4503401360545,553.4503401360545
2022,IL-520,Southern Illinois CoC,248,14,234,534.6430555555555,541.8729166666667
2022,IN-502,Indiana Balance of State CoC,3688,371,3317,639.2533426704015,694.1141643323996
2022,IN-503,Indianapolis CoC,1761,139,1622,721.0,722.0
2022,KS-502,Wichita/Sedgwick County CoC,690,100,590,578.0,550.6666666666666
2022,KS-503,Topeka/Shawnee County CoC,365,129,236,678.0,680.5
2022,KS-507,Kansas Balance of State CoC,929,196,733,606.3015318015318,612.6651265401265
2022,KY-500,Kentucky Balance of State CoC,2189,278,1911,569.79552154195,592.8231292517006
2022,KY-501,Louisville-Jefferson County CoC,1080,309,771,738.0,680.2
2022,KY-502,Lexington-Fayette County CoC,715,142,573,683.0,657.6666666666666
2022,LA-500,Lafayette/Acadiana CoC,351,105,246,566.1923076923076,605.8717948717949
2022,LA-502,"Shreveport, Bossier/Northwest Louisiana CoC",255,81,174,593.5416666666666,574.6527777777778
2022,LA-503,New Orleans/Jefferson Parish CoC,1214,47,1167,835.0,804.5833333333333
2022,LA-505,Monroe/Northeast Louisiana CoC,136,8,128,566.1404761904762,560.5
2022,LA-506,Slidell/Southeast Louisiana CoC,611,24,587,766.6354166666667,712.5833333333334
2022,LA-507,Alexandria/Central Louisiana CoC,75,24,51,577.265873015873,581.4503968253968
2022,LA-509,Louisiana Balance of State CoC,4731,148,4583,716.2127403846154,667.3721955128206
2022,MA-500,Boston CoC,4439,513,3926,1942.0,1585.7545647888783
2022,MA-503,Cape Cod Islands CoC,397,58,339,1474.75,1191.4916666666666
2022,MA-504,Springfield/Hampden County CoC,2294,245,2049,782.0,914.9819444444444
2022,MA-506,Worcester City & County CoC,1277,177,1100,1066.2333333333333,1002.2744556604003
2022,MA-507,"Pittsfield/Berkshire, Franklin, Hampshire Counties CoC",542,133,409,912.5833333333334,889.2875
2022,MA-511,"Quincy, Brockton, Weymouth, Plymouth City and County CoC",1008,226,782,1566.0740740740741,1435.3232142857141
2022,MA-516,Massachusetts Balance of State CoC,3235,226,3009,1842.253091977532,1177.2156744301906
2022,MA-519,"Attleboro, Taunton/Bristol County CoC",293,41,252,1027.25,1406.3690476190475
2022,MD-501,Baltimore CoC,1597,380,1217,1037.0,997.0
2022,MD-503,Annapolis/Anne Arundel County CoC,307,55,252,1037.0,967.7777777777778
2022,MD-505,Baltimore County CoC,468,149,319,1037.0,918.1666666666666
2022,MD-506,Carroll County CoC,76,26,50,1037.0,802.3333333333334
2022,MD-511,Mid-Shore Regional CoC,116,5,111,863.7,909.8333333333334
2022,MD-513,"Wicomico, Somerset, Worcester Counties CoC",237,39,198,756.625,744.9166666666666
2022,MD-514,Maryland Balance of State CoC,1269,275,994,926.7310606060607,770.6590909090909
2022,ME-500,Maine Statewide CoC,4411,679,3732,925.9785714285714,830.0216216216216
2022,MI-500,Michigan Balance of State CoC,1585,114,1471,647.0098584529505,698.4187200956939
2022,MI-502,"Dearborn, Dearborn Heights, Westland/Wayne County CoC",166,5,161,786.0,820.25
2022,MI-503,"St. Clair Shores, Warren/Macomb County CoC",272,40,232,786.0,748.0
2022,MI-504,"Pontiac, Royal Oak/Oakland County CoC",320,31,289,786.0,785.8333333333334
2022,MI-505,Flint/Genesee County CoC,360,50,310,575.0,687.3333333333334
2022,MI-506,"Grand Rapids, Wyoming/Kent County CoC",1044,202,842,849.0,712.6
2022,MI-507,"Portage, Kalamazoo City & County CoC",488,113,375,653.0,609.1666666666667
2022,MI-508,"Lansing, East Lansing/Ingham County CoC",515,66,449,778.0,726.0
2022,MI-509,Washtenaw County CoC,211,24,187,1136.0,699.1666666666666
2022,MI-510,Saginaw City & County CoC,313,23,290,591.0,547.3
2022,MI-511,Lenawee County CoC,158,12,146,570.0,697.8333333333334
2022,MI-512,"Grand Traverse, Antrim, Leelanau Counties CoC",164,56,108,663.7291666666667,626.6979166666667
2022,MI-514,Battle Creek/Calhoun County CoC,218,22,196,646.0,671.9375
2022,MI-515,Monroe City & County CoC,111,16,95,669.0,749.75
2022,MI-516,"Norton Shores, Muskegon City & County CoC",135,12,123,623.0,716.4
2022,MI-517,Jackson City & County CoC,90,16,74,651.0,737.8571428571429
2022,MI-518,Livingston County CoC,97,1,96,793.0,741.3333333333334
2022,MI-519,Holland/Ottawa County CoC,200,18,182,859.0,692.0
2022,MI-523,Eaton County CoC,68,4,64,778.0,679.25
2022,MN-500,Minneapolis/Hennepin County CoC,2678,580,2098,1004.0,968.0
2022,MN-501,Saint Paul/Ramsey County CoC,1713,664,1049,1004.0,968.0
2022,MN-502,Rochester/Southeast Minnesota CoC,485,109,376,609.2318376068376,657.7799145299145
2022,MN-503,"Dakota, Anoka, Washington, Scott, Carver Counties",746,196,550,1004.0,831.5694444444443
2022,MN-504,Northeast Minnesota CoC,113,18,95,610.5219047619047,575.9238095238095
2022,MN-505,St. Cloud/Central Minnesota CoC,916,158,758,794.5816326530612,669.4149659863945
2022,MN-506,Northwest Minnesota CoC,285,59,226,580.7166666666667,546.525
2022,MN-508,Moorhead/West Central Minnesota CoC,253,32,221,548.4399999999999,536.8933333333333
2022,MN-509,Duluth/St.Louis County CoC,555,185,370,742.0,580.8
2022,MN-511,Southwest Minnesota CoC,173,15,158,587.5542022792023,653.9306267806268
2022,MO-500,St. Louis County CoC,371,40,331,739.0,719.0
2022,MO-501,St.Louis City CoC,1147,263,884,739.0,719.0
2022,MO-503,"St. Charles City & County, Lincoln, Warren Counties CoC",425,16,409,739.0,667.0
2022,MO-600,"Springfield/Greene, Christian, Webster Counties CoC",517,181,336,636.0,506.3333333333333
2022,MO-602,"Joplin/Jasper, Newton Counties CoC",231,31,200,595.0,538.7222222222223
2022,MO-603,"St. Joseph/Andrew, Buchanan, DeKalb Counties CoC",148,53,95,575.0,588.0555555555555
2022,MO-606,Missouri Balance of State CoC,1571,378,1193,579.2019003679903,587.4205099686934
2022,MS-500,"Jackson/Rankin, Madison Counties CoC",654,59,595,705.3157894736842,568.6842105263158
2022,MS-501,Mississippi Balance of State CoC,342,43,299,592.4696115288222,620.3183439367649
2022,MS-503,Gulf Port/Gulf Coast Regional CoC,200,6,194,648.6785714285714,708.547619047619
2022,MT-500,Montana Statewide CoC,1585,381,1204,615.0818181818182,655.7469696969697
2022,NC-500,Winston-Salem/Forsyth County CoC,429,129,300,660.0,693.3333333333333
2022,NC-501,Asheville/Buncombe County CoC,637,211,426,1245.0,648.4166666666667
2022,NC-502,Durham City & County CoC,459,154,305,1101.0,967.4444444444445
2022,NC-503,North Carolina Balance of State CoC,2491,271,2220,759.0417931578226,743.1495300287946
2022,NC-504,"Greensboro, High Point CoC",426,65,361,871.0,658.9
2022,NC-505,Charlotte/Mecklenberg CoC,1761,341,1420,1080.0,851.1111111111112
2022,NC-506,"Wilmington/Brunswick, New Hanover, Pender Counties CoC",347,92,255,799.25,675.4166666666667
2022,NC-507,Raleigh/Wake County CoC,1534,308,1226,1117.0,953.6666666666667
2022,NC-509,"Gastonia/Cleveland, Gaston, Lincoln Counties CoC",497,164,333,690.4333333333334,728.8666666666667
2022,NC-511,Fayetteville/Cumberland County CoC,475,66,409,826.0,600.0
2022,NC-513,Chapel Hill/Orange County CoC,133,33,100,1101.0,885.625
2022,NC-516,Northwest North Carolina CoC,193,19,174,589.5975274725275,725.554945054945
2022,ND-500,North Dakota Statewide CoC,610,180,430,631.7973484848485,537.8963068181818
2022,NE-500,Nebraska Balance of State CoC,482,39,443,552.5285714285715,634.4613324175824
2022,NE-501,"Omaha, Council Bluffs CoC",1346,400,946,743.0,652.1666666666666
2022,NE-502,Lincoln CoC,418,94,324,672.0,557.25
2022,NH-500,New Hampshire Balance of State CoC,851,248,603,925.3229729729729,1024.0368000963826
2022,NH-502,Nashua/Hillsborough County CoC,241,30,211,1095.6451612903227,1194.3119864963003
2022,NJ-500,Atlantic City & County CoC,343,118,225,1010.0,1049.8333333333333
2022,NJ-501,Bergen County CoC,306,12,294,1334.0,1604.6666666666667
2022,NJ-502,Burlington County CoC,585,143,442,1013.0,1063.7142857142858
2022,NJ-503,"Camden City & County/Gloucester, Cape May, Cumberland Counties CoC",994,267,727,1018.875,962.7083333333334
2022,NJ-504,Newark/Essex County CoC,1914,254,1660,1094.0,1360.2
2022,NJ-506,"Jersey City, Bayonne/Hudson County CoC",665,154,511,1742.0,1430.75
2022,NJ-507,New Brunswick/Middlesex County CoC,586,156,430,1370.0,1355.0
2022,NJ-508,Monmouth County CoC,453,95,358,1175.0,1304.8
2022,NJ-509,Morris County CoC,351,62,289,1094.0,1250.2
2022,NJ-510,Lakewood Township/Ocean County CoC,419,38,381,1175.0,1063.0
2022,NJ-511,Paterson/Passaic County CoC,374,107,267,1334.0,1352.1666666666667
2022,NJ-513,Somerset County CoC,220,16,204,1370.0,1229.2
2022,NJ-514,Trenton/Mercer County CoC,533,100,433,1181.0,1173.0
2022,NJ-515,Elizabeth/Union County CoC,675,116,559,1094.0,1442.1666666666667
2022,NJ-516,"Warren, Sussex, Hunterdon Counties CoC",314,49,265,1198.857142857143,1148.25
2022,NM-501,New Mexico Balance of State CoC,1283,391,892,643.5880230880231,614.1445707070708
2022,NV-500,Las Vegas/Clark County CoC,5645,2363,3282,910.0,784.0
2022,NV-501,"Reno, Sparks/Washoe County CoC",1605,334,1271,1007.0,800.9666666666667
2022,NV-502,Nevada Balance of State CoC,368,102,266,747.5348324514991,818.5295414462081
2022,NY-500,"Rochester, Irondequoit, Greece/Monroe County CoC",748,126,622,772.0,720.8333333333334
2022,NY-501,"Elmira/Steuben, Allegany, Livingston, Chemung, Schuyler Counties CoC",497,9,488,705.0583333333333,686.0333333333333
2022,NY-503,Albany City & County CoC,734,142,592,959.0,853.5
2022,NY-505,"Syracuse, Auburn/Onondaga, Oswego, Cayuga Counties CoC",712,51,661,694.0666666666667,785.1333333333333
2022,NY-507,Schenectady City & County CoC,289,46,243,959.0,850.3333333333334
2022,NY-508,"Buffalo, Niagara Falls/Erie, Niagara, Orleans, Genesee, Wyoming Counties CoC",856,50,806,701.5,662.6666666666666
2022,NY-510,Ithaca/Tompkins County CoC,152,49,103,1153.0,700.0
2022,NY-511,"Binghamton, Union Town/Broome, Otsego, Chenango, Delaware, Cortland, Tioga Count",483,15,468,691.5875,781.84375
2022,NY-512,Troy/Rensselaer County CoC,148,16,132,959.0,816.225
2022,NY-513,"Wayne, Ontario, Seneca, Yates Counties CoC",372,26,346,727.25,792.7
2022,NY-514,"Jamestown, Dunkirk/Chautauqua County CoC",108,4,104,532.0,671.75
2022,NY-518,"Utica, Rome/Oneida, Madison Counties CoC",244,25,219,725.6666666666666,676.375
2022,NY-519,"Columbia, Greene Counties CoC",114,17,97,803.0,892.375
2022,NY-520,"Franklin, Essex Counties CoC",43,2,41,679.0,819.0
2022,NY-522,"Jefferson, Lewis, St. Lawrence Counties CoC",130,15,115,682.7,647.6666666666667
2022,NY-523,"Glens Falls, Saratoga Springs/Saratoga, Washington, Warren, Hamilton Counties Co",222,24,198,839.5714285714286,772.1309523809524
2022,NY-600,New York City CoC,61840,5529,56311,2160.0,1385.2857142857142
2022,NY-601,Poughkeepsie/Dutchess County CoC,636,87,549,1112.0,1112.6917701863354
2022,NY-602,"Newburgh, Middletown/Orange County CoC",339,41,298,1112.0,1287.0
2022,NY-603,"Nassau, Suffolk Counties CoC",3034,72,2962,1472.0,1316.162631700023
2022,NY-604,"Yonkers, Mount Vernon/Westchester County CoC",1356,119,1237,1467.0,1638.3695652173913
2022,NY-606,Rockland County CoC,106,30,76,2160.0,1460.0
2022,NY-608,Kingston/Ulster County CoC,409,74,335,1007.0,900.3
2022,OH-500,Cincinnati/Hamilton County CoC,1081,70,1011,690.0,633.0
2022,OH-501,Toledo/Lucas County CoC,494,88,406,588.0,602.25
2022,OH-502,Cleveland/Cuyahoga County CoC,1574,204,1370,674.0,620.2
2022,OH-503,Columbus/Franklin County CoC,1912,132,1780,782.0,773.8333333333334
2022,OH-504,Youngstown/Mahoning County CoC,174,5,169,526.0,544.5555555555555
2022,OH-505,"Dayton, Kettering/Montgomery County CoC",656,21,635,644.0,601.0
2022,OH-506,"Akron, Barberton/Summit County CoC",441,64,377,653.0,599.0
2022,OH-507,Ohio Balance of State CoC,4075,511,3564,596.9819509285196,604.6760711692084
2022,OH-508,"Canton, Massillon, Alliance/Stark County CoC",247,9,238,538.0,563.3333333333334
2022,OK-500,North Central Oklahoma CoC,214,74,140,654.1333333333333,591.9666666666667
2022,OK-501,Tulsa City & County CoC,1063,453,610,687.0,586.7777777777778
2022,OK-502,Oklahoma City CoC,1339,493,846,762.0,699.6666666666667
2022,OK-503,Oklahoma Balance of State CoC,216,121,95,624.829772079772,622.3216999050333
2022,OK-504,Norman/Cleveland County CoC,197,70,127,762.0,750.0
2022,OK-505,Northeast Oklahoma CoC,281,65,216,594.8979591836735,594.2244897959183
2022,OK-506,Southwest Oklahoma Regional CoC,134,19,115,591.4125,618.2895833333333
2022,OK-507,Southeastern Oklahoma Regional CoC,310,39,271,572.6604166666667,589.1083333333333
2022,OR-500,"Eugene, Springfield/Lane County CoC",2880,1293,1587,880.0,846.6
2022,OR-501,"Portland, Gresham/Multnomah County CoC",5228,3120,2108,1485.0,1237.5
2022,OR-502,"Medford, Ashland/Jackson County CoC",1251,251,1000,869.0,720.3333333333333
2022,OR-503,Central Oregon CoC,1359,165,1194,808.1666666666666,765.7666666666668
2022,OR-505,Oregon Balance of State CoC,4057,963,3094,825.328587962963,881.4711805555556
2022,OR-506,"Hillsboro, Beaverton/Washington County CoC",808,250,558,1485.0,1217.5
2022,OR-507,Clackamas County CoC,571,291,280,1485.0,1117.25
2022,PA-500,Philadelphia CoC,4489,1060,3429,1013.0,970.0
2022,PA-501,Harrisburg/Dauphin County CoC,423,65,358,780.0,681.0
2022,PA-502,"Upper Darby, Chester, Haverford/Delaware County CoC",335,8,327,1013.0,970.0
2022,PA-503,"Wilkes-Barre, Hazleton/Luzerne County CoC",150,5,145,647.0,666.0833333333333
2022,PA-504,"Lower Merion, Norristown, Abington/Montgomery County CoC",568,60,508,1013.0,900.8333333333334
2022,PA-505,Chester County CoC,402,32,370,1013.0,881.1666666666666
2022,PA-506,Reading/Berks County CoC,573,54,519,747.0,853.9166666666666
2022,PA-508,Scranton/Lackawanna County CoC,188,7,181,647.0,656.25
2022,PA-509,Eastern Pennsylvania CoC,2290,154,2136,783.9979166666666,784.1614583333334
2022,PA-510,Lancaster City & County CoC,472,5,467,841.0,793.9166666666666
2022,PA-511,"Bristol, Bensalem/Bucks County CoC",427,38,389,1013.0,1002.8333333333334
2022,PA-512,York City & County CoC,358,13,345,730.0,855.0
2022,PA-600,"Pittsburgh, McKeesport, Penn Hills/Allegheny County CoC",880,284,596,824.0,776.0
2022,PA-601,Western Pennsylvania CoC,735,73,662,674.1041666666666,625.0486111111111
2022,PA-603,Beaver County CoC,103,5,98,824.0,622.6666666666666
2022,PA-605,Erie City & County CoC,298,49,249,683.0,557.5
2022,PR-502,Puerto Rico Balance of Commonwealth CoC,1026,137,889,430.29411764705884,430.5
2022,PR-503,South-Southeast Puerto Rico CoC,1189,125,1064,438.5882352941176,423.5882352941176
2022,RI-500,Rhode Island Statewide CoC,1577,497,1080,1001.2,1213.3757142857144
2022,SC-500,Charleston/Low Country CoC,324,70,254,894.2380952380952,732.4791666666666
2022,SC-501,"Greenville, Anderson, Spartanburg/Upstate CoC",1263,283,980,667.5255555555556,619.9288888888889
2022,SC-502,Columbia/Midlands CoC,987,265,722,697.5773809523808,787.8013038548753
2022,SC-503,"Myrtle Beach, Sumter City & County CoC",1034,117,917,713.8011363636364,801.7585227272727
2022,SD-500,South Dakota Statewide CoC,1389,140,1249,602.5166797488226,543.4128074306645
2022,TN-500,Chattanooga/Southeast Tennessee CoC,3392,440,2952,616.4761904761906,564.5000000000001
2022,TN-501,Memphis/Shelby County CoC,1055,30,1025,742.0,662.5
2022,TN-502,Knoxville/Knox County CoC,1178,284,894,770.0,593.8571428571429
2022,TN-503,Central Tennessee CoC,387,38,349,803.3232142857142,716.7160714285715
2022,TN-504,Nashville-Davidson County CoC,1916,493,1423,1174.0,1078.0
2022,TN-506,Upper Cumberland CoC,382,57,325,775.8244897959183,775.5179138321995
2022,TN-507,Jackson/West Tennessee CoC,906,191,715,580.25,574.1523809523809
2022,TN-509,Appalachian Regional CoC,392,26,366,581.9821428571429,691.3630952380952
2022,TN-510,Murfreesboro/Rutherford County CoC,371,120,251,1174.0,957.6666666666666
2022,TN-512,"Morristown/Blount, Sevier, Campbell, Cocke Counties CoC",588,29,559,615.2244897959183,556.2738095238095
2022,TX-500,San Antonio/Bexar County CoC,2995,519,2476,882.0,787.8571428571429
2022,TX-503,Austin/Travis County CoC,3157,1639,1518,1177.0,999.0
2022,TX-600,"Dallas City & County, Irving CoC",4410,1009,3401,1166.0,991.4444444444445
2022,TX-601,"Fort Worth, Arlington/Tarrant County CoC",1665,196,1469,1012.0,981.1999999999999
2022,TX-603,El Paso City & County CoC,836,100,736,597.0,560.0
2022,TX-604,Waco/McLennan County CoC,195,36,159,589.4,673.3666666666667
2022,TX-607,Texas Balance of State CoC,7054,1141,5913,739.4987879767292,743.7491758241757
2022,TX-624,"Wichita Falls/Wise, Palo Pinto, Wichita, Archer Counties CoC",249,33,216,687.1619047619047,686.1
2022,TX-700,"Houston, Pasadena, Conroe/Harris, Ft. Bend, Montgomery, Counties CoC",3124,574,2550,1049.0,732.2307692307693
2022,TX-701,"Bryan, College Station/Brazos Valley CoC",86,5,81,669.7282051282051,766.2153846153846
2022,UT-500,Salt Lake City & County CoC,2095,567,1528,992.0,818.1666666666666
2022,UT-503,Utah Balance of State CoC,1221,160,1061,677.8826388888889,742.1840277777777
2022,UT-504,Provo/Mountainland CoC,241,65,176,1030.4555555555555,724.3000000000001
2022,VA-500,"Richmond/Henrico, Chesterfield, Hanover Counties CoC",697,222,475,1097.0,951.125
2022,VA-501,"Norfolk, Chesapeake, Suffolk/Isle of Wight, Southampton Counties CoC",738,157,581,975.7380952380952,864.9166666666666
2022,VA-502,"Roanoke City & County, Salem CoC",216,39,177,645.25,631.5555555555555
2022,VA-503,Virginia Beach CoC,352,51,301,1065.0,1032.0
2022,VA-504,Charlottesville CoC,266,55,211,1049.2878787878788,772.1363636363636
2022,VA-505,"Newport News, Hampton/Virginia Peninsula CoC",419,56,363,1065.0,966.1666666666666
2022,VA-508,Lynchburg CoC,84,2,82,802.0,749.3666666666667
2022,VA-513,"Harrisburg, Winchester/Western Virginia CoC",426,65,361,723.8968253968254,835.0
2022,VA-514,"Fredericksburg/Spotsylvania, Stafford Counties CoC",253,60,193,872.8,892.5
2022,VA-521,Virginia Balance of State CoC,1125,95,1030,626.7701812076812,725.3369623432122
2022,VA-603,Alexandria CoC,120,23,97,1662.0,1643.0
2022,VT-500,Vermont Balance of State CoC,2112,297,1815,869.3083333333334,844.6071428571429
2022,VT-501,Burlington/Chittenden County CoC,668,152,516,1114.0,803.0666666666666
2022,WA-500,Seattle/King County CoC,13368,4705,8663,1789.0,1164.111111111111
2022,WA-501,Washington Balance of State CoC,5854,1915,3939,764.7395833333334,1076.8715277777776
2022,WA-502,Spokane City & County CoC,1757,564,1193,743.0,635.9583333333333
2022,WA-503,"Tacoma, Lakewood/Pierce County CoC",1851,454,1397,1133.0,1229.25
2022,WA-504,Everett/Snohomish County CoC,1184,582,602,1789.0,1245.25
2022,WI-500,Wisconsin Balance of State CoC,3049,432,2617,685.5296435533277,724.7661988304094
2022,WI-501,Milwaukee City & County CoC,832,43,789,732.0,704.75
2022,WI-502,Racine City & County CoC,193,7,186,654.0,736.0833333333334
2022,WI-503,Madison/Dane County CoC,701,169,532,995.0,648.7142857142857
2022,WV-500,"Wheeling, Weirton Area CoC",122,19,103,576.3,675.4000000000001
2022,WV-501,"Huntington/Cabell, Wayne Counties CoC",235,15,220,611.0,578.9791666666666
2022,WV-503,"Charleston/Kanawha, Putnam, Boone, Clay Counties CoC",298,52,246,669.5294117647059,577.4117647058824
2022,WV-508,West Virginia Balance of State CoC,720,135,585,612.6666956654456,600.7444309775193
2022,WY-500,Wyoming Statewide CoC,648,85,563,724.9088744588744,721.9527597402597
2021,AK-500,Anchorage CoC,1319,271,1048,937.0,785.0
2021,AK-501,Alaska Balance of State CoC,630,111,519,780.0,994.0
2021,AL-500,"Birmingham/Jefferson, St. Clair, Shelby Counties CoC",875,230,645,891.0,734.7777777777778
2021,AL-501,Mobile City & County/Baldwin County CoC,219,7,212,748.95,636.525
2021,AL-502,Florence/Northwest Alabama CoC,183,19,164,532.8333333333333,536.8
2021,AL-503,Huntsville/North Alabama CoC,300,67,233,612.75,507.41666666666663
2021,AL-504,Montgomery City & County CoC,215,55,160,660.4375,522.25
2021,AL-506,Tuscaloosa City & County CoC,37,15,22,742.0,744.6666666666667
2021,AL-507,Alabama Balance of State CoC,190,11,179,554.1853066867772,673.446681749623
2021,AR-500,Little Rock/Central Arkansas CoC,401,149,252,682.0333333333333,563.5833333333333
2021,AR-501,Fayetteville/Northwest Arkansas CoC,157,19,138,561.9,505.18333333333334
2021,AR-503,Arkansas  Balance of State  CoC,1190,178,1012,545.1445098039216,573.4430392156862
2021,AR-505,Southeast Arkansas CoC,67,25,42,533.9038095238095,563.7595238095239
2021,AZ-500,Arizona Balance of State CoC,989,185,804,696.8525,732.1166666666667
2021,AZ-501,Tucson/Pima County CoC,821,183,638,670.0,794.9
2021,AZ-502,"Phoenix, Mesa/Maricopa County CoC",3650,588,3062,1004.0,693.3
2021,CA-500,San Jose/Santa Clara City & County CoC,2301,1028,1273,2354.0,1438.5
2021,CA-501,San Francisco CoC,4000,1668,2332,2447.0,1969.0
2021,CA-502,"Oakland, Berkeley/Alameda County CoC",2546,950,1596,1768.0,1678.5
2021,CA-503,Sacramento City & County CoC,1885,634,1251,1138.0,1070.625
2021,CA-504,"Santa Rosa, Petaluma/Sonoma County CoC",787,245,542,1462.0,1339.3333333333333
2021,CA-505,Richmond/Contra Costa County CoC,820,396,424,1768.0,1521.5714285714287
2021,CA-506,"Salinas/Monterey, San Benito Counties CoC",678,157,521,1388.0,1256.3333333333333
2021,CA-507,Marin County CoC,225,64,161,2447.0,1636.5
2021,CA-508,Watsonville/Santa Cruz City & County CoC,800,276,524,2061.0,1979.8333333333333
2021,CA-509,Mendocino County CoC,318,134,184,971.0,832.2
2021,CA-510,"Turlock, Modesto/Stanislaus County CoC",2927,539,2388,942.0,1218.2666666666667
2021,CA-511,Stockton/San Joaquin County CoC,885,170,715,909.0,1191.7
2021,CA-512,Daly/San Mateo County CoC,621,213,408,2447.0,1980.0
2021,CA-513,"Visalia/Kings, Tulare Counties CoC",494,101,393,877.4,1005.8
2021,CA-514,Fresno City & County/Madera County CoC,999,239,760,877.8,919.7
2021,CA-515,"Roseville, Rocklin/Placer County CoC",708,240,468,1138.0,895.5
2021,CA-516,"Redding/Shasta, Siskiyou, Lassen, Plumas, Del Norte, Modoc, Sierra Counties CoC",792,97,695,757.8518518518517,761.9074074074074
2021,CA-517,Napa City & County CoC,200,72,128,1454.0,1102.25
2021,CA-518,Vallejo/Solano County CoC,397,154,243,1300.0,1464.3333333333333
2021,CA-519,"Chico, Paradise/Butte County CoC",499,133,366,879.0,720.5
2021,CA-520,Merced City & County CoC,835,21,814,779.0,1209.4
2021,CA-521,"Davis, Woodland/Yolo County CoC",373,168,205,1183.0,969.0
2021,CA-522,Humboldt County CoC,272,118,154,793.0,715.3333333333334
2021,CA-523,"Colusa, Glenn, Trinity Counties CoC",140,9,131,661.125,804.1875
2021,CA-524,Yuba City & County/Sutter County CoC,1074,302,772,941.0,905.7857142857143
2021,CA-525,El Dorado County CoC,99,16,83,1138.0,909.4
2021,CA-526,"Amador, Calaveras, Mariposa, Tuolumne Counties CoC",151,19,132,837.4523809523808,862.6785714285714
2021,CA-600,Los Angeles City & County CoC,17225,4215,13010,1488.0,1192.25
2021,CA-601,San Diego City and County CoC,4143,804,3339,1569.0,1111.3333333333333
2021,CA-602,"Santa Ana, Anaheim/Orange County CoC",2441,460,1981,1805.0,1191.0
2021,CA-603,Santa Maria/Santa Barbara County CoC,500,236,264,1867.0,1126.0
2021,CA-604,Bakersfield/Kern County CoC,2150,1,2149,786.0,1204.142857142857
2021,CA-608,Riverside City & County CoC,998,195,803,1035.0,1092.4
2021,CA-609,San Bernardino City & County CoC,905,57,848,1035.0,1007.0714285714286
2021,CA-611,"Oxnard, San Buenaventura/Ventura County CoC",949,332,617,1387.0,1320.6666666666667
2021,CA-613,Imperial County CoC,140,1,139,744.0,1019.8333333333334
2021,CA-614,San Luis Obispo County CoC,297,104,193,1257.0,1229.75
2021,CO-500,Colorado Balance of State CoC,1295,531,764,756.1869347319347,692.3725174825174
2021,CO-503,Metropolitan Denver CoC,5530,1095,4435,1307.576923076923,849.0128205128204
2021,CO-504,Colorado Springs/El Paso County CoC,1156,182,974,867.0,992.4
2021,CT-503,"Bridgeport, Stamford, Norwalk, Danbury/Fairfield County CoC",549,32,517,1224.2173913043478,1361.7
2021,CT-505,Connecticut Balance of State CoC,2044,135,1909,882.8878306878306,1030.2640527950311
2021,DE-500,Delaware Statewide CoC,1579,183,1396,901.4642857142857,883.4285714285714
2021,FL-500,"Sarasota, Bradenton/Manatee, Sarasota Counties CoC",526,72,454,912.0,797.25
2021,FL-501,Tampa/Hillsborough County CoC,870,64,806,1070.0,855.6
2021,FL-502,"St. Petersburg, Clearwater, Largo/Pinellas County CoC",2307,213,2094,1070.0,1002.0
2021,FL-503,"Lakeland, Winterhaven/Polk County CoC",385,22,363,853.0,914.2777777777777
2021,FL-504,"Deltona, Daytona Beach/Volusia, Flagler Counties CoC",694,24,670,747.25,833.0
2021,FL-505,"Fort Walton Beach/Okaloosa, Walton Counties CoC",73,18,55,971.5,635.5
2021,FL-506,Tallahassee/Leon County CoC,621,197,424,711.4074074074074,622.7129629629629
2021,FL-507,"Orlando/Orange, Osceola, Seminole Counties CoC",1544,158,1386,1135.0,784.75
2021,FL-508,"Gainesville/Alachua, Putnam Counties CoC",677,179,498,683.0,732.0
2021,FL-509,"Fort Pierce/St. Lucie, Indian River, Martin Counties CoC",814,0,814,852.2,905.3
2021,FL-510,"Jacksonville-Duval, Clay Counties CoC",1222,29,1193,801.0,688.8333333333334
2021,FL-511,"Pensacola/Escambia, Santa Rosa Counties CoC",731,1,730,833.0,763.0
2021,FL-512,St. Johns County CoC,420,71,349,801.0,753.0
2021,FL-513,"Palm Bay, Melbourne/Brevard County CoC",432,15,417,804.0,851.3333333333334
2021,FL-514,Ocala/Marion County CoC,512,156,356,740.0,760.5555555555555
2021,FL-515,"Panama City/Bay, Jackson Counties CoC",101,3,98,557.3333333333333,655.3333333333334
2021,FL-517,"Hendry, Hardee, Highlands Counties CoC",27,2,25,675.9333333333333,956.4
2021,FL-518,"Columbia, Hamilton, Lafayette, Suwannee Counties CoC",69,0,69,650.3666666666667,633.15
2021,FL-519,Pasco County CoC,857,361,496,1070.0,900.125
2021,FL-520,"Citrus, Hernando, Lake, Sumter Counties CoC",638,42,596,949.5833333333334,814.3333333333334
2021,FL-600,Miami-Dade County CoC,3224,553,2671,1148.0,1131.0
2021,FL-601,Ft Lauderdale/Broward County CoC,2561,208,2353,1142.0,994.0
2021,FL-602,Punta Gorda/Charlotte County CoC,154,3,151,847.0,817.4166666666666
2021,FL-603,"Ft Myers, Cape Coral/Lee County CoC",394,57,337,997.0,836.6666666666666
2021,FL-604,Monroe County CoC,242,24,218,1441.0,1065.5
2021,FL-605,West Palm Beach/Palm Beach County CoC,458,61,397,1065.0,938.4444444444445
2021,FL-606,Naples/Collier County CoC,568,73,495,1014.0,1055.0
2021,GA-500,Atlanta CoC,1996,406,1590,1101.0,1065.0
2021,GA-501,Georgia Balance of State CoC,1896,144,1752,734.8221068819685,722.5421953094965
2021,GA-503,Athens-Clarke County CoC,133,32,101,710.0,777.0
2021,GA-504,Augusta-Richmond County CoC,144,5,139,689.0,724.75
2021,GA-505,Columbus-Muscogee CoC,236,15,221,697.0,628.0
2021,GA-506,Marietta/Cobb County CoC,252,9,243,1101.0,1065.0
2021,GA-507,Savannah/Chatham County CoC,548,32,516,948.0,812.3333333333333
2021,GA-508,DeKalb County CoC,200,0,200,1101.0,1065.0
2021,IA-500,"Sioux City/Dakota, Woodbury Counties CoC",233,41,192,577.0,513.1
2021,IA-501,Iowa Balance of State CoC,1725,207,1518,557.9443556443558,556.7905094905095
2021,IA-502,Des Moines/Polk County CoC,576,132,444,645.0,623.1428571428571
2021,ID-500,Boise/Ada County CoC,575,79,496,718.0,624.2
2021,ID-501,Idaho Balance of State CoC,1314,28,1286,630.1145833333334,643.8034722222222
2021,IL-500,McHenry County CoC,49,7,42,1104.0,892.6
2021,IL-501,"Rockford/DeKalb, Winnebago, Boone Counties CoC",287,31,256,675.6,866.3
2021,IL-502,"Waukegan, North Chicago/Lake County CoC",372,46,326,1104.0,859.0833333333334
2021,IL-503,"Champaign, Urbana, Rantoul/Champaign County CoC",148,15,133,793.0,597.25
2021,IL-506,"Joliet, Bolingbrook/Will County CoC",257,11,246,1065.1904761904764,806.8571428571429
2021,IL-507,"Peoria, Pekin/Fulton, Tazewell, Peoria, Woodford Counties CoC",202,50,152,641.6666666666666,538.3888888888888
2021,IL-511,Cook County CoC,1044,230,814,1104.0,924.2857142857143
2021,IL-512,Bloomington/Central Illinois CoC,275,27,248,593.9179894179895,619.9960317460316
2021,IL-513,Springfield/Sangamon County CoC,189,67,122,611.0,518.4166666666666
2021,IL-514,DuPage County CoC,425,68,357,1104.0,1047.3333333333333
2021,IL-515,South Central Illinois CoC,151,2,149,564.7907407407407,580.9802469135803
2021,IL-516,Decatur/Macon County CoC,83,24,59,544.0,565.3333333333333
2021,IL-517,"Aurora, Elgin/Kane County CoC",251,68,183,1104.0,984.2
2021,IL-518,"Rock Island, Moline/Northwestern Illinois CoC",95,0,95,563.8265306122449,616.0986394557823
2021,IL-519,West Central Illinois CoC,111,3,108,503.2278911564626,528.1591836734694
2021,IL-520,Southern Illinois CoC,159,0,159,518.0659722222222,522.5631944444444
2021,IN-502,Indiana Balance of State CoC,3047,215,2832,615.4381979458451,665.3739402427638
2021,IN-503,Indianapolis CoC,1928,105,1823,722.0,718.0
2021,KS-502,Wichita/Sedgwick County CoC,419,49,370,595.0,529.8333333333334
2021,KS-503,Topeka/Shawnee County CoC,294,100,194,643.0,675.6666666666666
2021,KS-507,Kansas Balance of State CoC,783,40,743,600.2308524808524,579.3646769896769
2021,KY-500,Kentucky Balance of State CoC,969,124,845,559.0917233560091,573.2241496598639
2021,KY-501,Louisville-Jefferson County CoC,1013,292,721,692.0,645.6
2021,KY-502,Lexington-Fayette County CoC,562,151,411,677.0,619.1666666666666
2021,LA-500,Lafayette/Acadiana CoC,349,74,275,598.8846153846154,576.3589743589744
2021,LA-502,"Shreveport, Bossier/Northwest Louisiana CoC",198,65,133,607.1527777777777,578.9166666666666
2021,LA-503,New Orleans/Jefferson Parish CoC,1042,32,1010,813.0,820.0833333333333
2021,LA-505,Monroe/Northeast Louisiana CoC,78,4,74,580.0714285714286,543.3071428571428
2021,LA-506,Slidell/Southeast Louisiana CoC,70,0,70,759.25,693.1666666666667
2021,LA-507,Alexandria/Central Louisiana CoC,64,18,46,613.3690476190476,564.6984126984127
2021,LA-509,Louisiana Balance of State CoC,330,27,303,732.285657051282,659.7972756410256
2021,MA-500,Boston CoC,4548,605,3943,1842.0,1575.4949164851128
2021,MA-503,Cape Cod Islands CoC,343,66,277,1297.75,1166.927777777778
2021,MA-504,Springfield/Hampden County CoC,2248,109,2139,798.0,884.6645833333333
2021,MA-506,Worcester City & County CoC,1196,139,1057,1015.9666666666669,952.7436422597714
2021,MA-507,"Pittsfield/Berkshire, Franklin, Hampshire Counties CoC",425,72,353,885.4609375,851.9041666666667
2021,MA-511,"Quincy, Brockton, Weymouth, Plymouth City and County CoC",943,255,688,1459.3333333333333,1378.575
2021,MA-516,Massachusetts Balance of State CoC,3102,225,2877,1741.6577779259853,1136.4554683715976
2021,MA-519,"Attleboro, Taunton/Bristol County CoC",224,45,179,923.65,1308.513888888889
2021,MD-501,Baltimore CoC,1631,276,1355,997.0,970.0
2021,MD-503,Annapolis/Anne Arundel County CoC,244,46,198,997.0,953.4444444444445
2021,MD-505,Baltimore County CoC,270,108,162,997.0,900.1666666666666
2021,MD-506,Carroll County CoC,85,31,54,997.0,771.0
2021,MD-511,Mid-Shore Regional CoC,122,19,103,846.6666666666666,873.5333333333334
2021,MD-513,"Wicomico, Somerset, Worcester Counties CoC",214,53,161,723.6666666666666,754.5833333333334
2021,MD-514,Maryland Balance of State CoC,790,107,683,853.9280303030301,748.9469696969696
2021,ME-500,Maine Statewide CoC,2063,298,1765,881.4642857142859,821.6972972972974
2021,MI-500,Michigan Balance of State CoC,1014,54,960,628.7547946570972,657.7999700956938
2021,MI-502,"Dearborn, Dearborn Heights, Westland/Wayne County CoC",169,9,160,748.0,754.75
2021,MI-503,"St. Clair Shores, Warren/Macomb County CoC",330,86,244,748.0,687.0
2021,MI-504,"Pontiac, Royal Oak/Oakland County CoC",333,33,300,748.0,714.1666666666666
2021,MI-505,Flint/Genesee County CoC,336,61,275,550.0,621.1666666666666
2021,MI-506,"Grand Rapids, Wyoming/Kent County CoC",894,111,783,787.0,661.8000000000001
2021,MI-507,"Portage, Kalamazoo City & County CoC",342,41,301,659.0,571.3333333333333
2021,MI-508,"Lansing, East Lansing/Ingham County CoC",372,41,331,751.0,678.125
2021,MI-509,Washtenaw County CoC,269,52,217,1118.0,648.3333333333334
2021,MI-510,Saginaw City & County CoC,331,24,307,579.0,527.2
2021,MI-511,Lenawee County CoC,97,14,83,561.0,656.1666666666666
2021,MI-512,"Grand Traverse, Antrim, Leelanau Counties CoC",202,52,150,652.2708333333333,562.34375
2021,MI-514,Battle Creek/Calhoun County CoC,149,16,133,591.0,641.875
2021,MI-515,Monroe City & County CoC,103,13,90,667.0,679.75
2021,MI-516,"Norton Shores, Muskegon City & County CoC",105,13,92,629.0,663.7
2021,MI-517,Jackson City & County CoC,119,5,114,668.0,680.4285714285714
2021,MI-518,Livingston County CoC,77,10,67,803.0,691.6666666666666
2021,MI-519,Holland/Ottawa County CoC,139,2,137,848.0,651.8
2021,MI-523,Eaton County CoC,83,4,79,751.0,647.0
2021,MN-500,Minneapolis/Hennepin County CoC,2369,639,1730,968.0,888.0
2021,MN-501,Saint Paul/Ramsey County CoC,1872,689,1183,968.0,888.0
2021,MN-502,Rochester/Southeast Minnesota CoC,419,69,350,574.2510683760684,622.1752136752136
2021,MN-503,"Dakota, Anoka, Washington, Scott, Carver Counties",610,156,454,968.0,774.8055555555557
2021,MN-504,Northeast Minnesota CoC,73,4,69,543.6742857142856,570.6476190476191
2021,MN-505,St. Cloud/Central Minnesota CoC,536,114,422,746.5408163265305,657.0935374149659
2021,MN-506,Northwest Minnesota CoC,249,37,212,531.4833333333333,540.3416666666667
2021,MN-508,Moorhead/West Central Minnesota CoC,186,25,161,502.3666666666667,537.1066666666667
2021,MN-509,Duluth/St.Louis County CoC,348,109,239,701.0,579.4
2021,MN-511,Southwest Minnesota CoC,113,9,104,533.197150997151,621.1350427350427
2021,MO-500,St. Louis County CoC,341,25,316,719.0,679.0
2021,MO-501,St.Louis City CoC,997,143,854,719.0,679.0
2021,MO-503,"St. Charles City & County, Lincoln, Warren Counties CoC",456,23,433,719.0,627.9444444444445
2021,MO-600,"Springfield/Greene, Christian, Webster Counties CoC",583,137,446,627.0,480.6666666666667
2021,MO-602,"Joplin/Jasper, Newton Counties CoC",210,27,183,607.0,518.0555555555555
2021,MO-603,"St. Joseph/Andrew, Buchanan, DeKalb Counties CoC",150,29,121,569.0,568.2222222222222
2021,MO-606,Missouri Balance of State CoC,764,138,626,544.0746937990883,569.9724240676663
2021,MS-500,"Jackson/Rankin, Madison Counties CoC",147,15,132,669.7894736842105,541.640350877193
2021,MS-501,Mississippi Balance of State CoC,268,51,217,570.5686331212647,603.0602708694814
2021,MS-503,Gulf Port/Gulf Coast Regional CoC,211,2,209,628.7857142857142,722.5952380952381
2021,MT-500,Montana Statewide CoC,1801,59,1742,624.860606060606,631.25
2021,NC-500,Winston-Salem/Forsyth County CoC,462,146,316,663.0,660.0833333333333
2021,NC-501,Asheville/Buncombe County CoC,527,154,373,1176.0,654.5833333333333
2021,NC-502,Durham City & County CoC,396,119,277,1044.0,914.0
2021,NC-503,North Carolina Balance of State CoC,1520,138,1382,722.122928150281,706.227985396956
2021,NC-504,"Greensboro, High Point CoC",482,92,390,772.0,623.7
2021,NC-505,Charlotte/Mecklenberg CoC,1947,426,1521,1066.0,773.8333333333334
2021,NC-506,"Wilmington/Brunswick, New Hanover, Pender Counties CoC",301,51,250,716.1666666666667,709.4166666666667
2021,NC-507,Raleigh/Wake County CoC,912,102,810,1092.0,899.9166666666667
2021,NC-509,"Gastonia/Cleveland, Gaston, Lincoln Counties CoC",277,61,216,682.8666666666667,687.8666666666667
2021,NC-511,Fayetteville/Cumberland County CoC,54,0,54,781.0,589.5
2021,NC-513,Chapel Hill/Orange County CoC,176,36,140,1044.0,835.125
2021,NC-516,Northwest North Carolina CoC,195,10,185,553.2060439560439,698.2939560439561
2021,ND-500,North Dakota Statewide CoC,548,132,416,603.2637310606061,520.3224431818182
2021,NE-500,Nebraska Balance of State CoC,425,36,389,544.0287164224665,596.758920940171
2021,NE-501,"Omaha, Council Bluffs CoC",1190,288,902,743.0,614.9166666666667
2021,NE-502,Lincoln CoC,320,66,254,664.0,534.875
2021,NH-500,New Hampshire Balance of State CoC,775,241,534,877.5052927927928,973.3124329839462
2021,NH-502,Nashua/Hillsborough County CoC,197,29,168,973.4516129032259,1166.0021236923196
2021,NJ-500,Atlantic City & County CoC,326,111,215,1012.0,1003.6666666666666
2021,NJ-501,Bergen County CoC,279,4,275,1341.0,1511.0833333333333
2021,NJ-502,Burlington County CoC,604,117,487,970.0,1014.1428571428571
2021,NJ-503,"Camden City & County/Gloucester, Cape May, Cumberland Counties CoC",935,239,696,972.0,921.2083333333334
2021,NJ-504,Newark/Essex County CoC,1888,172,1716,1221.0,1219.4
2021,NJ-506,"Jersey City, Bayonne/Hudson County CoC",882,205,677,1677.0,1320.5
2021,NJ-507,New Brunswick/Middlesex County CoC,628,162,466,1297.0,1284.0
2021,NJ-508,Monmouth County CoC,322,56,266,1207.0,1247.4
2021,NJ-509,Morris County CoC,268,57,211,1221.0,1168.5333333333333
2021,NJ-510,Lakewood Township/Ocean County CoC,369,65,304,1207.0,1012.3333333333334
2021,NJ-511,Paterson/Passaic County CoC,324,110,214,1341.0,1248.0
2021,NJ-513,Somerset County CoC,226,22,204,1297.0,1166.2
2021,NJ-514,Trenton/Mercer County CoC,393,25,368,1110.0,1147.3333333333333
2021,NJ-515,Elizabeth/Union County CoC,571,86,485,1221.0,1337.0
2021,NJ-516,"Warren, Sussex, Hunterdon Counties CoC",229,35,194,1208.7142857142858,1074.2142857142858
2021,NM-501,New Mexico Balance of State CoC,1180,252,928,657.6512445887446,564.9532828282828
2021,NV-500,Las Vegas/Clark County CoC,5083,1673,3410,830.0,749.75
2021,NV-501,"Reno, Sparks/Washoe County CoC",1708,197,1511,856.0,764.2666666666667
2021,NV-502,Nevada Balance of State CoC,299,10,289,643.4479717813051,762.1834215167548
2021,NY-500,"Rochester, Irondequoit, Greece/Monroe County CoC",521,73,448,742.0,692.8333333333334
2021,NY-501,"Elmira/Steuben, Allegany, Livingston, Chemung, Schuyler Counties CoC",256,4,252,693.9958333333333,664.6833333333333
2021,NY-503,Albany City & County CoC,723,103,620,873.0,786.2
2021,NY-505,"Syracuse, Auburn/Onondaga, Oswego, Cayuga Counties CoC",469,33,436,673.9666666666667,764.1
2021,NY-507,Schenectady City & County CoC,266,21,245,873.0,787.5
2021,NY-508,"Buffalo, Niagara Falls/Erie, Niagara, Orleans, Genesee, Wyoming Counties CoC",663,47,616,676.7083333333334,636.0
2021,NY-510,Ithaca/Tompkins County CoC,144,33,111,1078.0,673.25
2021,NY-511,"Binghamton, Union Town/Broome, Otsego, Chenango, Delaware, Cortland, Tioga Count",318,0,318,688.525,733.8499999999999
2021,NY-512,Troy/Rensselaer County CoC,173,30,143,873.0,794.0375
2021,NY-513,"Wayne, Ontario, Seneca, Yates Counties CoC",309,23,286,722.9,754.5
2021,NY-514,"Jamestown, Dunkirk/Chautauqua County CoC",107,6,101,593.0,630.75
2021,NY-518,"Utica, Rome/Oneida, Madison Counties CoC",143,23,120,646.3125,653.8125
2021,NY-519,"Columbia, Greene Counties CoC",117,12,105,775.5,840.5982142857143
2021,NY-520,"Franklin, Essex Counties CoC",40,1,39,669.7,782.2
2021,NY-522,"Jefferson, Lewis, St. Lawrence Counties CoC",93,2,91,681.6333333333333,624.0
2021,NY-523,"Glens Falls, Saratoga Springs/Saratoga, Washington, Warren, Hamilton Counties Co",237,21,216,794.7142857142857,737.9642857142857
2021,NY-600,New York City CoC,68358,6621,61737,1940.0,1324.7857142857142
2021,NY-601,Poughkeepsie/Dutchess County CoC,536,60,476,1169.0,1060.921195652174
2021,NY-602,"Newburgh, Middletown/Orange County CoC",280,35,245,1169.0,1199.5714285714287
2021,NY-603,"Nassau, Suffolk Counties CoC",3050,46,3004,1445.0,1303.0220151828848
2021,NY-604,"Yonkers, Mount Vernon/Westchester County CoC",1383,118,1265,1509.0,1553.2101449275362
2021,NY-606,Rockland County CoC,53,7,46,1940.0,1410.7
2021,NY-608,Kingston/Ulster County CoC,340,27,313,912.0,848.0
2021,OH-500,Cincinnati/Hamilton County CoC,1016,143,873,653.0,594.0
2021,OH-501,Toledo/Lucas County CoC,383,162,221,572.0,572.0
2021,OH-502,Cleveland/Cuyahoga County CoC,1557,148,1409,640.0,610.8
2021,OH-503,Columbus/Franklin County CoC,1365,39,1326,768.0,723.6666666666666
2021,OH-504,Youngstown/Mahoning County CoC,62,3,59,511.0,541.3888888888888
2021,OH-505,"Dayton, Kettering/Montgomery County CoC",568,34,534,600.0,562.8571428571429
2021,OH-506,"Akron, Barberton/Summit County CoC",394,68,326,607.0,589.6666666666666
2021,OH-507,Ohio Balance of State CoC,2336,174,2162,581.5405410312272,582.4533587509078
2021,OH-508,"Canton, Massillon, Alliance/Stark County CoC",234,21,213,525.0,550.9444444444445
2021,OK-500,North Central Oklahoma CoC,132,43,89,621.2,556.2333333333333
2021,OK-501,Tulsa City & County CoC,1043,229,814,644.0,571.7777777777778
2021,OK-502,Oklahoma City CoC,672,117,555,750.0,668.5
2021,OK-503,Oklahoma Balance of State CoC,125,68,57,610.0608974358975,593.7054843304844
2021,OK-504,Norman/Cleveland County CoC,106,49,57,750.0,729.0
2021,OK-505,Northeast Oklahoma CoC,79,20,59,580.2278911564625,576.5850340136054
2021,OK-506,Southwest Oklahoma Regional CoC,61,4,57,559.4458333333333,574.0666666666666
2021,OK-507,Southeastern Oklahoma Regional CoC,476,63,413,566.3166666666667,562.9729166666667
2021,OR-500,"Eugene, Springfield/Lane County CoC",2317,1031,1286,837.0,816.1
2021,OR-501,"Portland, Gresham/Multnomah County CoC",1780,491,1289,1313.0,1186.0
2021,OR-502,"Medford, Ashland/Jackson County CoC",773,220,553,762.0,679.3333333333333
2021,OR-503,Central Oregon CoC,1116,165,951,759.2666666666668,721.4
2021,OR-505,Oregon Balance of State CoC,1305,211,1094,771.6383101851852,844.4344907407407
2021,OR-506,"Hillsboro, Beaverton/Washington County CoC",716,125,591,1313.0,1170.75
2021,OR-507,Clackamas County CoC,492,212,280,1313.0,1059.0833333333335
2021,PA-500,Philadelphia CoC,4302,933,3369,970.0,931.0
2021,PA-501,Harrisburg/Dauphin County CoC,358,69,289,694.0,671.5
2021,PA-502,"Upper Darby, Chester, Haverford/Delaware County CoC",279,3,276,970.0,931.0
2021,PA-503,"Wilkes-Barre, Hazleton/Luzerne County CoC",138,0,138,624.0,627.9166666666667
2021,PA-504,"Lower Merion, Norristown, Abington/Montgomery County CoC",261,41,220,970.0,851.3333333333334
2021,PA-505,Chester County CoC,327,17,310,970.0,850.0
2021,PA-506,Reading/Berks County CoC,513,69,444,674.0,821.1666666666666
2021,PA-508,Scranton/Lackawanna County CoC,165,15,150,624.0,623.25
2021,PA-509,Eastern Pennsylvania CoC,1396,57,1339,749.525,752.1635416666667
2021,PA-510,Lancaster City & County CoC,394,6,388,733.0,762.25
2021,PA-511,"Bristol, Bensalem/Bucks County CoC",282,33,249,970.0,942.6666666666666
2021,PA-512,York City & County CoC,237,3,234,680.0,827.5833333333334
2021,PA-600,"Pittsburgh, McKeesport, Penn Hills/Allegheny County CoC",692,48,644,776.0,715.0
2021,PA-601,Western Pennsylvania CoC,603,11,592,645.5208333333334,605.0833333333334
2021,PA-603,Beaver County CoC,138,5,133,776.0,581.3333333333334
2021,PA-605,Erie City & County CoC,254,56,198,671.0,549.3333333333334
2021,PR-502,Puerto Rico Balance of Commonwealth CoC,314,35,279,423.5882352941176,418.61764705882354
2021,PR-503,South-Southeast Puerto Rico CoC,125,55,70,430.5,408.3235294117647
2021,RI-500,Rhode Island Statewide CoC,1267,357,910,922.7,1177.8090476190478
2021,SC-500,Charleston/Low Country CoC,274,49,225,832.6904761904763,703.0744047619048
2021,SC-501,"Greenville, Anderson, Spartanburg/Upstate CoC",783,166,617,625.1544444444444,626.4844444444445
2021,SC-502,Columbia/Midlands CoC,938,120,818,660.0456349206349,759.6712018140589
2021,SC-503,"Myrtle Beach, Sumter City & County CoC",1212,90,1122,649.8494318181818,744.2784090909091
2021,SD-500,South Dakota Statewide CoC,817,68,749,565.7615122972267,526.2099358974359
2021,TN-500,Chattanooga/Southeast Tennessee CoC,1482,231,1251,568.5396825396825,546.2539682539683
2021,TN-501,Memphis/Shelby County CoC,739,6,733,732.0,639.3333333333334
2021,TN-502,Knoxville/Knox County CoC,786,107,679,669.0,605.9285714285714
2021,TN-503,Central Tennessee CoC,292,0,292,747.1928571428571,669.6491071428571
2021,TN-504,Nashville-Davidson County CoC,1107,160,947,1078.0,967.0
2021,TN-506,Upper Cumberland CoC,382,44,338,724.0657596371883,726.6575963718822
2021,TN-507,Jackson/West Tennessee CoC,891,70,821,571.1119047619048,547.0607142857143
2021,TN-509,Appalachian Regional CoC,310,49,261,563.827380952381,673.1964285714286
2021,TN-510,Murfreesboro/Rutherford County CoC,362,2,360,1078.0,872.5
2021,TN-512,"Morristown/Blount, Sevier, Campbell, Cocke Counties CoC",472,16,456,562.3948979591837,551.7833333333334
2021,TX-500,San Antonio/Bexar County CoC,1499,229,1270,818.0,723.2857142857143
2021,TX-503,Austin/Travis County CoC,2954,1475,1479,1144.0,931.0
2021,TX-600,"Dallas City & County, Irving CoC",4570,792,3778,1121.0,922.6111111111111
2021,TX-601,"Fort Worth, Arlington/Tarrant County CoC",1300,165,1135,967.0,925.4333333333334
2021,TX-603,El Paso City & County CoC,528,31,497,590.0,549.0
2021,TX-604,Waco/McLennan County CoC,143,18,125,570.3666666666666,650.0333333333333
2021,TX-607,Texas Balance of State CoC,2562,214,2348,708.0255458593695,699.8095561301443
2021,TX-624,"Wichita Falls/Wise, Palo Pinto, Wichita, Archer Counties CoC",156,11,145,670.6857142857143,648.2071428571429
2021,TX-700,"Houston, Pasadena, Conroe/Harris, Ft. Bend, Montgomery, Counties CoC",3047,454,2593,1008.0,690.3846153846154
2021,TX-701,"Bryan, College Station/Brazos Valley CoC",49,3,46,614.5846153846154,703.9692307692308
2021,UT-500,Salt Lake City & County CoC,2314,545,1769,889.0,774.3333333333333
2021,UT-503,Utah Balance of State CoC,1056,93,963,648.7909722222222,713.4458333333333
2021,UT-504,Provo/Mountainland CoC,195,4,191,912.8888888888888,694.3000000000001
2021,VA-500,"Richmond/Henrico, Chesterfield, Hanover Counties CoC",834,168,666,1069.0,907.21875
2021,VA-501,"Norfolk, Chesapeake, Suffolk/Isle of Wight, Southampton Counties CoC",564,118,446,901.9404761904763,858.6071428571429
2021,VA-502,"Roanoke City & County, Salem CoC",250,56,194,635.5833333333334,629.3472222222222
2021,VA-503,Virginia Beach CoC,348,90,258,1032.0,1025.0
2021,VA-504,Charlottesville CoC,177,65,112,960.2727272727273,732.030303030303
2021,VA-505,"Newport News, Hampton/Virginia Peninsula CoC",322,49,273,1032.0,934.0555555555555
2021,VA-508,Lynchburg CoC,47,5,42,680.0,684.6
2021,VA-513,"Harrisburg, Winchester/Western Virginia CoC",267,38,229,698.3690476190477,800.3928571428572
2021,VA-514,"Fredericksburg/Spotsylvania, Stafford Counties CoC",180,33,147,1008.2,841.4
2021,VA-521,Virginia Balance of State CoC,870,36,834,612.4602890165391,692.4274087024087
2021,VA-603,Alexandria CoC,106,21,85,1643.0,1593.0
2021,VT-500,Vermont Balance of State CoC,1891,317,1574,849.2785714285714,792.5446428571429
2021,VT-501,Burlington/Chittenden County CoC,700,166,534,1161.0,762.8666666666667
2021,WA-500,Seattle/King County CoC,5183,1301,3882,1659.0,1164.5555555555554
2021,WA-501,Washington Balance of State CoC,3462,493,2969,720.40625,1076.6527777777776
2021,WA-502,Spokane City & County CoC,992,255,737,714.0,613.1666666666667
2021,WA-503,"Tacoma, Lakewood/Pierce County CoC",1005,249,756,1088.0,1259.25
2021,WA-504,Everett/Snohomish County CoC,494,149,345,1659.0,1272.25
2021,WI-500,Wisconsin Balance of State CoC,2420,278,2142,650.6308159287107,691.6190643274854
2021,WI-501,Milwaukee City & County CoC,817,116,701,704.0,658.25
2021,WI-502,Racine City & County CoC,145,30,115,638.0,685.5
2021,WI-503,Madison/Dane County CoC,855,245,610,958.0,636.8571428571429
2021,WV-500,"Wheeling, Weirton Area CoC",86,16,70,544.95,645.6333333333334
2021,WV-501,"Huntington/Cabell, Wayne Counties CoC",170,21,149,586.0,561.375
2021,WV-503,"Charleston/Kanawha, Putnam, Boone, Clay Counties CoC",263,55,208,627.2941176470588,579.7941176470588
2021,WV-508,West Virginia Balance of State CoC,619,99,520,609.840814479638,582.5099727070315
2021,WY-500,Wyoming Statewide CoC,405,25,380,706.611038961039,681.9057359307359
2020,AK-500,Anchorage CoC,1058,141,917,994.0,803.0
2020,AK-501,Alaska Balance of State CoC,891,216,675,785.0,989.0
2020,AL-500,"Birmingham/Jefferson, St. Clair, Shelby Counties CoC",848,150,698,875.0,669.3333333333333
2020,AL-501,Mobile City & County/Baldwin County CoC,631,71,560,771.35,642.95
2020,AL-502,Florence/Northwest Alabama CoC,215,18,197,504.8,516.8666666666667
2020,AL-503,Huntsville/North Alabama CoC,561,139,422,589.125,487.6875
2020,AL-504,Montgomery City & County CoC,351,74,277,598.5,523.9375
2020,AL-506,Tuscaloosa City & County CoC,67,0,67,768.0,669.0
2020,AL-507,Alabama Balance of State CoC,398,10,388,535.2038964303671,651.33633107089
2020,AR-500,Little Rock/Central Arkansas CoC,1186,272,914,629.2,560.4833333333333
2020,AR-501,Fayetteville/Northwest Arkansas CoC,352,98,254,579.2333333333333,502.2166666666667
2020,AR-503,Arkansas  Balance of State  CoC,773,128,645,515.3161764705882,563.8522549019608
2020,AR-505,Southeast Arkansas CoC,55,16,39,512.4695238095238,545.6290476190477
2020,AZ-500,Arizona Balance of State CoC,2236,651,1585,653.165,686.4958333333333
2020,AZ-501,Tucson/Pima County CoC,1324,383,941,657.0,731.7
2020,AZ-502,"Phoenix, Mesa/Maricopa County CoC",7419,1052,6367,911.0,658.8
2020,CA-500,San Jose/Santa Clara City & County CoC,9605,2526,7079,2221.0,1365.8333333333333
2020,CA-501,San Francisco CoC,8124,2837,5287,2288.0,1858.5
2020,CA-502,"Oakland, Berkeley/Alameda County CoC",8137,2437,5700,1650.0,1573.5
2020,CA-503,Sacramento City & County CoC,5511,1727,3784,1025.0,972.875
2020,CA-504,"Santa Rosa, Petaluma/Sonoma County CoC",2745,562,2183,1405.0,1235.3333333333333
2020,CA-505,Richmond/Contra Costa County CoC,2277,699,1578,1650.0,1416.7142857142858
2020,CA-506,"Salinas/Monterey, San Benito Counties CoC",2683,603,2080,1430.5,1170.8333333333333
2020,CA-507,Marin County CoC,1032,251,781,2288.0,1525.75
2020,CA-508,Watsonville/Santa Cruz City & County CoC,2256,445,1811,1761.0,1838.3333333333333
2020,CA-509,Mendocino County CoC,751,99,652,866.0,789.0
2020,CA-510,"Turlock, Modesto/Stanislaus County CoC",2107,336,1771,832.0,1135.6666666666665
2020,CA-511,Stockton/San Joaquin County CoC,2677,742,1935,792.0,1113.6
2020,CA-512,Daly/San Mateo County CoC,1572,363,1209,2288.0,1865.25
2020,CA-513,"Visalia/Kings, Tulare Counties CoC",1297,529,768,838.4,917.2
2020,CA-514,Fresno City & County/Madera County CoC,3641,645,2996,792.9333333333333,849.7666666666667
2020,CA-515,"Roseville, Rocklin/Placer County CoC",744,276,468,1025.0,790.5833333333334
2020,CA-516,"Redding/Shasta, Siskiyou, Lassen, Plumas, Del Norte, Modoc, Sierra Counties CoC",1529,430,1099,707.6296296296296,712.537037037037
2020,CA-517,Napa City & County CoC,464,202,262,1323.0,1021.25
2020,CA-518,Vallejo/Solano County CoC,1162,232,930,1203.0,1363.3333333333333
2020,CA-519,"Chico, Paradise/Butte County CoC",1274,278,996,807.0,652.625
2020,CA-520,Merced City & County CoC,636,194,442,686.0,1144.7
2020,CA-521,"Davis, Woodland/Yolo County CoC",641,175,466,1095.0,859.1666666666666
2020,CA-522,Humboldt County CoC,1701,523,1178,740.0,682.6666666666666
2020,CA-523,"Colusa, Glenn, Trinity Counties CoC",261,44,217,643.25,756.125
2020,CA-524,Yuba City & County/Sutter County CoC,721,231,490,889.0,857.6428571428571
2020,CA-525,El Dorado County CoC,663,107,556,1025.0,814.4
2020,CA-526,"Amador, Calaveras, Mariposa, Tuolumne Counties CoC",834,252,582,801.3690476190477,788.0
2020,CA-600,Los Angeles City & County CoC,63706,24482,39224,1382.0,1104.0
2020,CA-601,San Diego City and County CoC,7638,1519,6119,1490.0,1024.3333333333333
2020,CA-602,"Santa Ana, Anaheim/Orange County CoC",6978,2810,4168,1688.0,1115.75
2020,CA-603,Santa Maria/Santa Barbara County CoC,1897,620,1277,1818.0,1039.0
2020,CA-604,Bakersfield/Kern County CoC,1580,4,1576,762.0,1085.2142857142858
2020,CA-608,Riverside City & County CoC,2884,1007,1877,946.0,1025.8
2020,CA-609,San Bernardino City & County CoC,3125,760,2365,946.0,936.2142857142857
2020,CA-611,"Oxnard, San Buenaventura/Ventura County CoC",1787,429,1358,1373.0,1160.3333333333333
2020,CA-613,Imperial County CoC,1527,750,777,700.0,979.3333333333334
2020,CA-614,San Luis Obispo County CoC,1423,331,1092,1243.0,1058.75
2020,CO-500,Colorado Balance of State CoC,1638,579,1059,697.7497047397048,663.3449883449882
2020,CO-503,Metropolitan Denver CoC,6104,1867,4237,1247.4871794871794,794.0448717948717
2020,CO-504,Colorado Springs/El Paso County CoC,1339,284,1055,807.0,939.7
2020,CT-503,"Bridgeport, Stamford, Norwalk, Danbury/Fairfield County CoC",697,44,653,1226.2608695652175,1275.1
2020,CT-505,Connecticut Balance of State CoC,2208,133,2075,847.1706349206348,988.5596014492754
2020,DE-500,Delaware Statewide CoC,1165,267,898,871.0833333333334,872.9642857142857
2020,FL-500,"Sarasota, Bradenton/Manatee, Sarasota Counties CoC",1044,188,856,873.0,766.25
2020,FL-501,Tampa/Hillsborough County CoC,1452,266,1186,1002.0,816.8
2020,FL-502,"St. Petersburg, Clearwater, Largo/Pinellas County CoC",2226,592,1634,1002.0,917.0
2020,FL-503,"Lakeland, Winterhaven/Polk County CoC",612,78,534,744.0,860.1666666666666
2020,FL-504,"Deltona, Daytona Beach/Volusia, Flagler Counties CoC",904,76,828,806.25,777.8333333333334
2020,FL-505,"Fort Walton Beach/Okaloosa, Walton Counties CoC",351,183,168,916.5,625.6666666666666
2020,FL-506,Tallahassee/Leon County CoC,805,192,613,667.2685185185186,610.2777777777777
2020,FL-507,"Orlando/Orange, Osceola, Seminole Counties CoC",2007,489,1518,1063.0,743.0
2020,FL-508,"Gainesville/Alachua, Putnam Counties CoC",880,225,655,670.7777777777777,698.2916666666666
2020,FL-509,"Fort Pierce/St. Lucie, Indian River, Martin Counties CoC",1379,45,1334,831.0,848.95
2020,FL-510,"Jacksonville-Duval, Clay Counties CoC",1366,71,1295,750.0,653.8333333333334
2020,FL-511,"Pensacola/Escambia, Santa Rosa Counties CoC",746,184,562,850.0,741.3333333333334
2020,FL-512,St. Johns County CoC,367,43,324,750.0,774.0
2020,FL-513,"Palm Bay, Melbourne/Brevard County CoC",940,245,695,745.0,794.3333333333334
2020,FL-514,Ocala/Marion County CoC,523,130,393,708.0,718.4444444444445
2020,FL-515,"Panama City/Bay, Jackson Counties CoC",385,43,342,553.5833333333334,631.5833333333334
2020,FL-517,"Hendry, Hardee, Highlands Counties CoC",403,98,305,685.795,898.0600000000001
2020,FL-518,"Columbia, Hamilton, Lafayette, Suwannee Counties CoC",578,65,513,669.9166666666666,611.0500000000001
2020,FL-519,Pasco County CoC,898,265,633,1002.0,843.625
2020,FL-520,"Citrus, Hernando, Lake, Sumter Counties CoC",703,58,645,893.25,768.1666666666666
2020,FL-600,Miami-Dade County CoC,3560,524,3036,1166.0,1032.6666666666667
2020,FL-601,Ft Lauderdale/Broward County CoC,2211,654,1557,1109.0,922.0
2020,FL-602,Punta Gorda/Charlotte County CoC,169,23,146,842.0,775.25
2020,FL-603,"Ft Myers, Cape Coral/Lee County CoC",444,93,351,933.0,798.5
2020,FL-604,Monroe County CoC,421,31,390,1319.0,972.0
2020,FL-605,West Palm Beach/Palm Beach County CoC,1510,241,1269,1097.0,870.3333333333334
2020,FL-606,Naples/Collier County CoC,603,80,523,965.0,947.2
2020,GA-500,Atlanta CoC,3240,542,2698,1065.0,1005.0
2020,GA-501,Georgia Balance of State CoC,4349,256,4093,729.0405997693197,704.0613033448673
2020,GA-503,Athens-Clarke County CoC,210,51,159,735.0,724.4
2020,GA-504,Augusta-Richmond County CoC,470,95,375,746.0,721.5
2020,GA-505,Columbus-Muscogee CoC,249,29,220,638.0,642.1666666666667
2020,GA-506,Marietta/Cobb County CoC,424,61,363,1065.0,1005.0
2020,GA-507,Savannah/Chatham County CoC,672,294,378,907.0,803.6666666666667
2020,GA-508,DeKalb County CoC,344,36,308,1065.0,1005.0
2020,IA-500,"Sioux City/Dakota, Woodbury Counties CoC",305,34,271,556.0,515.7666666666667
2020,IA-501,Iowa Balance of State CoC,1696,220,1476,531.8606837606837,551.9503385503385
2020,IA-502,Des Moines/Polk County CoC,646,114,532,642.0,622.0
2020,ID-500,Boise/Ada County CoC,647,129,518,645.0,572.8
2020,ID-501,Idaho Balance of State CoC,1668,235,1433,597.6902777777777,591.8361111111111
2020,IL-500,McHenry County CoC,155,14,141,1045.0,846.3
2020,IL-501,"Rockford/DeKalb, Winnebago, Boone Counties CoC",465,37,428,667.0,832.5
2020,IL-502,"Waukegan, North Chicago/Lake County CoC",292,24,268,1045.0,807.5
2020,IL-503,"Champaign, Urbana, Rantoul/Champaign County CoC",140,25,115,778.0,562.5
2020,IL-506,"Joliet, Bolingbrook/Will County CoC",276,24,252,1028.0,776.1904761904763
2020,IL-507,"Peoria, Pekin/Fulton, Tazewell, Peoria, Woodford Counties CoC",311,59,252,578.1111111111111,540.9444444444443
2020,IL-511,Cook County CoC,846,174,672,1045.0,882.2857142857143
2020,IL-512,Bloomington/Central Illinois CoC,408,71,337,583.2301587301587,607.7645502645503
2020,IL-513,Springfield/Sangamon County CoC,294,73,221,569.0,518.0833333333334
2020,IL-514,DuPage County CoC,328,50,278,1045.0,1004.6666666666666
2020,IL-515,South Central Illinois CoC,123,10,113,550.5660493827161,571.0962962962963
2020,IL-516,Decatur/Macon County CoC,135,28,107,517.0,574.111111111111
2020,IL-517,"Aurora, Elgin/Kane County CoC",410,101,309,1045.0,945.2
2020,IL-518,"Rock Island, Moline/Northwestern Illinois CoC",135,16,119,532.6224489795919,605.734693877551
2020,IL-519,West Central Illinois CoC,113,3,110,497.46666666666664,529.7102040816327
2020,IL-520,Southern Illinois CoC,233,22,211,509.4201388888889,514.9993055555556
2020,IN-502,Indiana Balance of State CoC,4037,271,3766,598.0046965452849,651.0763211951446
2020,IN-503,Indianapolis CoC,1588,132,1456,718.0,692.0
2020,KS-502,Wichita/Sedgwick County CoC,619,48,571,568.0,499.6666666666667
2020,KS-503,Topeka/Shawnee County CoC,467,163,304,631.0,627.0
2020,KS-507,Kansas Balance of State CoC,943,109,834,580.4771894771895,561.8740009990009
2020,KY-500,Kentucky Balance of State CoC,2220,308,1912,531.1348072562358,555.8469387755102
2020,KY-501,Louisville-Jefferson County CoC,1102,269,833,654.0,623.0
2020,KY-502,Lexington-Fayette County CoC,689,89,600,642.0,634.1666666666666
2020,LA-500,Lafayette/Acadiana CoC,417,112,305,612.5641025641025,546.8461538461538
2020,LA-502,"Shreveport, Bossier/Northwest Louisiana CoC",298,55,243,608.4722222222223,546.4305555555555
2020,LA-503,New Orleans/Jefferson Parish CoC,1314,113,1201,828.0,764.4166666666667
2020,LA-505,Monroe/Northeast Louisiana CoC,162,21,141,585.3809523809524,527.6285714285714
2020,LA-506,Slidell/Southeast Louisiana CoC,118,12,106,745.5416666666666,667.9583333333333
2020,LA-507,Alexandria/Central Louisiana CoC,107,13,94,607.8452380952381,532.875
2020,LA-509,Louisiana Balance of State CoC,757,111,646,698.0897435897435,628.5388621794872
2020,MA-500,Boston CoC,6134,683,5451,1813.0,1486.3520334059551
2020,MA-503,Cape Cod Islands CoC,336,56,280,1088.25,1123.800925925926
2020,MA-504,Springfield/Hampden County CoC,2257,139,2118,777.0,850.1368055555555
2020,MA-506,Worcester City & County CoC,1401,169,1232,986.2333333333335,931.93390510326
2020,MA-507,"Pittsfield/Berkshire, Franklin, Hampshire Counties CoC",591,79,512,867.86328125,827.5395833333333
2020,MA-511,"Quincy, Brockton, Weymouth, Plymouth City and County CoC",1079,198,881,1464.5555555555557,1322.3125
2020,MA-516,Massachusetts Balance of State CoC,3631,291,3340,1715.6137047411555,1091.084677304032
2020,MA-519,"Attleboro, Taunton/Bristol County CoC",250,13,237,869.3,1262.212962962963
2020,MD-501,Baltimore CoC,2193,586,1607,970.0,931.0
2020,MD-503,Annapolis/Anne Arundel County CoC,319,54,265,970.0,919.5555555555555
2020,MD-505,Baltimore County CoC,712,188,524,970.0,871.1666666666666
2020,MD-506,Carroll County CoC,130,28,102,970.0,757.0
2020,MD-511,Mid-Shore Regional CoC,157,28,129,860.7,869.0
2020,MD-513,"Wicomico, Somerset, Worcester Counties CoC",310,73,237,643.5833333333334,768.75
2020,MD-514,Maryland Balance of State CoC,1264,379,885,833.6969696969699,740.0075757575759
2020,ME-500,Maine Statewide CoC,2097,248,1849,799.7857142857141,832.081081081081
2020,MI-500,Michigan Balance of State CoC,1502,124,1378,591.5957635566187,640.8874700956939
2020,MI-502,"Dearborn, Dearborn Heights, Westland/Wayne County CoC",260,31,229,687.0,747.75
2020,MI-503,"St. Clair Shores, Warren/Macomb County CoC",251,23,228,687.0,665.0
2020,MI-504,"Pontiac, Royal Oak/Oakland County CoC",459,61,398,687.0,695.3333333333334
2020,MI-505,Flint/Genesee County CoC,349,48,301,545.0,615.5
2020,MI-506,"Grand Rapids, Wyoming/Kent County CoC",923,185,738,728.0,687.1333333333333
2020,MI-507,"Portage, Kalamazoo City & County CoC",639,160,479,615.0,558.25
2020,MI-508,"Lansing, East Lansing/Ingham County CoC",512,33,479,726.0,670.0
2020,MI-509,Washtenaw County CoC,274,59,215,983.0,649.1666666666666
2020,MI-510,Saginaw City & County CoC,431,22,409,530.0,513.8
2020,MI-511,Lenawee County CoC,168,22,146,512.0,646.0
2020,MI-512,"Grand Traverse, Antrim, Leelanau Counties CoC",211,54,157,592.9479166666667,558.0416666666667
2020,MI-514,Battle Creek/Calhoun County CoC,229,58,171,548.0,631.625
2020,MI-515,Monroe City & County CoC,184,17,167,662.0,669.0
2020,MI-516,"Norton Shores, Muskegon City & County CoC",129,9,120,610.0,656.0
2020,MI-517,Jackson City & County CoC,100,6,94,646.0,666.2857142857143
2020,MI-518,Livingston County CoC,47,1,46,696.0,678.8333333333334
2020,MI-519,Holland/Ottawa County CoC,270,8,262,754.0,648.6
2020,MI-523,Eaton County CoC,111,1,110,726.0,632.1666666666666
2020,MN-500,Minneapolis/Hennepin County CoC,3049,711,2338,888.0,823.0
2020,MN-501,Saint Paul/Ramsey County CoC,1630,417,1213,888.0,823.0
2020,MN-502,Rochester/Southeast Minnesota CoC,459,79,380,553.0929487179487,587.0106837606838
2020,MN-503,"Dakota, Anoka, Washington, Scott, Carver Counties",561,115,446,888.0,725.4305555555557
2020,MN-504,Northeast Minnesota CoC,143,11,132,558.8609523809523,564.752380952381
2020,MN-505,St. Cloud/Central Minnesota CoC,864,142,722,714.1292517006802,622.6479591836734
2020,MN-506,Northwest Minnesota CoC,320,60,260,546.0583333333334,534.875
2020,MN-508,Moorhead/West Central Minnesota CoC,223,32,191,497.21999999999997,518.1133333333333
2020,MN-509,Duluth/St.Louis County CoC,612,206,406,642.0,561.8
2020,MN-511,Southwest Minnesota CoC,79,14,65,527.2590455840456,591.9994301994302
2020,MO-500,St. Louis County CoC,479,47,432,679.0,680.0
2020,MO-501,St.Louis City CoC,1260,326,934,679.0,680.0
2020,MO-503,"St. Charles City & County, Lincoln, Warren Counties CoC",392,18,374,679.0,629.1666666666666
2020,MO-600,"Springfield/Greene, Christian, Webster Counties CoC",540,134,406,612.0,470.8333333333333
2020,MO-602,"Joplin/Jasper, Newton Counties CoC",313,56,257,548.0,504.8888888888889
2020,MO-603,"St. Joseph/Andrew, Buchanan, DeKalb Counties CoC",241,86,155,589.0,550.5
2020,MO-606,Missouri Balance of State CoC,1569,260,1309,513.0495001922337,562.4618800461361
2020,MS-500,"Jackson/Rankin, Madison Counties CoC",406,80,326,649.8947368421052,500.4824561403509
2020,MS-501,Mississippi Balance of State CoC,447,63,384,540.4130759591286,594.7205995758627
2020,MS-503,Gulf Port/Gulf Coast Regional CoC,254,3,251,646.7797619047619,687.1785714285714
2020,MT-500,Montana Statewide CoC,1545,223,1322,593.6242424242424,605.7984848484849
2020,NC-500,Winston-Salem/Forsyth County CoC,504,136,368,618.0,610.75
2020,NC-501,Asheville/Buncombe County CoC,547,110,437,1115.0,615.8333333333333
2020,NC-502,Durham City & County CoC,349,61,288,979.0,825.1111111111112
2020,NC-503,North Carolina Balance of State CoC,3185,324,2861,693.828709721651,679.3725726724256
2020,NC-504,"Greensboro, High Point CoC",624,33,591,734.0,592.9
2020,NC-505,Charlotte/Mecklenberg CoC,1604,286,1318,976.0,754.6111111111112
2020,NC-506,"Wilmington/Brunswick, New Hanover, Pender Counties CoC",350,52,298,674.8333333333333,701.75
2020,NC-507,Raleigh/Wake County CoC,974,103,871,1030.0,828.6666666666667
2020,NC-509,"Gastonia/Cleveland, Gaston, Lincoln Counties CoC",325,78,247,659.1,669.1333333333333
2020,NC-511,Fayetteville/Cumberland County CoC,297,40,257,774.0,605.6666666666666
2020,NC-513,Chapel Hill/Orange County CoC,124,13,111,979.0,762.5
2020,NC-516,Northwest North Carolina CoC,397,36,361,542.4271978021978,616.1978021978022
2020,ND-500,North Dakota Statewide CoC,541,92,449,592.1107954545455,486.3716856060606
2020,NE-500,Nebraska Balance of State CoC,542,19,523,517.6956730769231,573.0161782661783
2020,NE-501,"Omaha, Council Bluffs CoC",1405,338,1067,692.0,601.0833333333334
2020,NE-502,Lincoln CoC,457,106,351,672.0,539.625
2020,NH-500,New Hampshire Balance of State CoC,877,340,537,844.0925675675676,960.1752260136535
2020,NH-502,Nashua/Hillsborough County CoC,300,33,267,858.6129032258065,1108.0098912638127
2020,NJ-500,Atlantic City & County CoC,443,146,297,939.0,935.25
2020,NJ-501,Bergen County CoC,352,9,343,1233.0,1420.4166666666667
2020,NJ-502,Burlington County CoC,553,97,456,931.0,949.0
2020,NJ-503,"Camden City & County/Gloucester, Cape May, Cumberland Counties CoC",1047,265,782,921.0833333333334,903.75
2020,NJ-504,Newark/Essex County CoC,2209,313,1896,1114.0,1183.6
2020,NJ-506,"Jersey City, Bayonne/Hudson County CoC",944,314,630,1403.0,1284.5
2020,NJ-507,New Brunswick/Middlesex County CoC,666,90,576,1285.0,1206.0
2020,NJ-508,Monmouth County CoC,399,88,311,1167.0,1164.0
2020,NJ-509,Morris County CoC,354,51,303,1114.0,1154.6666666666665
2020,NJ-510,Lakewood Township/Ocean County CoC,349,44,305,1167.0,946.3333333333334
2020,NJ-511,Paterson/Passaic County CoC,583,122,461,1233.0,1214.3333333333333
2020,NJ-513,Somerset County CoC,342,18,324,1285.0,1131.6
2020,NJ-514,Trenton/Mercer County CoC,556,71,485,1033.0,1083.6666666666667
2020,NJ-515,Elizabeth/Union County CoC,484,42,442,1114.0,1277.0
2020,NJ-516,"Warren, Sussex, Hunterdon Counties CoC",349,64,285,1140.7380952380952,1040.2142857142858
2020,NM-501,New Mexico Balance of State CoC,1747,981,766,636.8423520923521,566.647637085137
2020,NV-500,Las Vegas/Clark County CoC,5283,1131,4152,774.0,704.75
2020,NV-501,"Reno, Sparks/Washoe County CoC",1231,148,1083,749.0,705.5333333333333
2020,NV-502,Nevada Balance of State CoC,386,90,296,652.6468253968254,693.0277777777778
2020,NY-500,"Rochester, Irondequoit, Greece/Monroe County CoC",815,96,719,710.0,670.3333333333334
2020,NY-501,"Elmira/Steuben, Allegany, Livingston, Chemung, Schuyler Counties CoC",252,15,237,656.375,645.0083333333333
2020,NY-503,Albany City & County CoC,820,116,704,806.0,794.8
2020,NY-505,"Syracuse, Auburn/Onondaga, Oswego, Cayuga Counties CoC",618,53,565,650.3,747.0
2020,NY-507,Schenectady City & County CoC,434,17,417,806.0,796.5
2020,NY-508,"Buffalo, Niagara Falls/Erie, Niagara, Orleans, Genesee, Wyoming Counties CoC",872,29,843,629.7916666666666,622.5
2020,NY-510,Ithaca/Tompkins County CoC,133,60,73,1016.0,646.5
2020,NY-511,"Binghamton, Union Town/Broome, Otsego, Chenango, Delaware, Cortland, Tioga Count",317,39,278,669.65625,715.725
2020,NY-512,Troy/Rensselaer County CoC,232,14,218,806.0,808.5375
2020,NY-513,"Wayne, Ontario, Seneca, Yates Counties CoC",301,67,234,702.075,724.85
2020,NY-514,"Jamestown, Dunkirk/Chautauqua County CoC",112,5,107,566.0,625.0
2020,NY-518,"Utica, Rome/Oneida, Madison Counties CoC",191,23,168,623.7916666666666,624.8125
2020,NY-519,"Columbia, Greene Counties CoC",170,1,169,707.0,837.1696428571429
2020,NY-520,"Franklin, Essex Counties CoC",39,0,39,645.55,742.2
2020,NY-522,"Jefferson, Lewis, St. Lawrence Counties CoC",67,7,60,679.6666666666667,607.0666666666667
2020,NY-523,"Glens Falls, Saratoga Springs/Saratoga, Washington, Warren, Hamilton Counties Co",308,52,256,750.0,731.7738095238095
2020,NY-600,New York City CoC,77943,6460,71483,1821.0,1242.5
2020,NY-601,Poughkeepsie/Dutchess County CoC,591,7,584,1092.0,1015.728649068323
2020,NY-602,"Newburgh, Middletown/Orange County CoC",471,68,403,1092.0,1145.2142857142858
2020,NY-603,"Nassau, Suffolk Counties CoC",3807,99,3708,1397.0,1224.289169542213
2020,NY-604,"Yonkers, Mount Vernon/Westchester County CoC",1683,130,1553,1674.5,1459.9855072463768
2020,NY-606,Rockland County CoC,193,76,117,1821.0,1331.7
2020,NY-608,Kingston/Ulster County CoC,439,36,403,839.0,812.0
2020,OH-500,Cincinnati/Hamilton County CoC,1092,74,1018,612.0,605.6666666666666
2020,OH-501,Toledo/Lucas County CoC,602,66,536,537.0,581.3333333333334
2020,OH-502,Cleveland/Cuyahoga County CoC,1675,171,1504,627.0,581.2
2020,OH-503,Columbus/Franklin County CoC,2036,177,1859,726.0,684.8333333333334
2020,OH-504,Youngstown/Mahoning County CoC,100,6,94,512.0,534.9444444444445
2020,OH-505,"Dayton, Kettering/Montgomery County CoC",736,18,718,557.0,558.8571428571429
2020,OH-506,"Akron, Barberton/Summit County CoC",587,46,541,600.0,579.75
2020,OH-507,Ohio Balance of State CoC,3577,192,3385,555.8149756198776,568.8065541031227
2020,OH-508,"Canton, Massillon, Alliance/Stark County CoC",250,3,247,528.0,532.4444444444445
2020,OK-500,North Central Oklahoma CoC,221,28,193,605.2,535.7
2020,OK-501,Tulsa City & County CoC,1221,256,965,636.0,551.5555555555555
2020,OK-502,Oklahoma City CoC,1573,441,1132,729.0,627.5
2020,OK-503,Oklahoma Balance of State CoC,161,75,86,568.8767806267806,570.2989078822413
2020,OK-504,Norman/Cleveland County CoC,266,215,51,729.0,678.0
2020,OK-505,Northeast Oklahoma CoC,55,32,23,544.1394557823129,547.7925170068028
2020,OK-506,Southwest Oklahoma Regional CoC,165,8,157,512.2645833333333,555.2270833333333
2020,OK-507,Southeastern Oklahoma Regional CoC,270,73,197,528.5104166666666,559.45
2020,OR-500,"Eugene, Springfield/Lane County CoC",1606,545,1061,817.0,720.8
2020,OR-501,"Portland, Gresham/Multnomah County CoC",4173,1837,2336,1258.0,1121.8333333333333
2020,OR-502,"Medford, Ashland/Jackson County CoC",727,297,430,767.0,617.3333333333333
2020,OR-503,Central Oregon CoC,913,194,719,732.9,647.8333333333334
2020,OR-505,Oregon Balance of State CoC,5642,1116,4526,747.4939814814816,786.9788194444445
2020,OR-506,"Hillsboro, Beaverton/Washington County CoC",618,149,469,1258.0,1101.6666666666667
2020,OR-507,Clackamas County CoC,352,156,196,1258.0,995.9166666666666
2020,PA-500,Philadelphia CoC,5634,1145,4489,931.0,908.0
2020,PA-501,Harrisburg/Dauphin County CoC,402,39,363,659.0,679.8333333333334
2020,PA-502,"Upper Darby, Chester, Haverford/Delaware County CoC",367,13,354,931.0,908.0
2020,PA-503,"Wilkes-Barre, Hazleton/Luzerne County CoC",181,3,178,599.0,613.6666666666667
2020,PA-504,"Lower Merion, Norristown, Abington/Montgomery County CoC",282,51,231,931.0,852.8333333333334
2020,PA-505,Chester County CoC,522,41,481,931.0,852.3333333333334
2020,PA-506,Reading/Berks County CoC,524,47,477,642.0,825.1666666666666
2020,PA-508,Scranton/Lackawanna County CoC,177,10,167,599.0,614.125
2020,PA-509,Eastern Pennsylvania CoC,2032,117,1915,699.8583333333333,747.7604166666667
2020,PA-510,Lancaster City & County CoC,461,6,455,734.0,772.25
2020,PA-511,"Bristol, Bensalem/Bucks County CoC",333,33,300,931.0,930.6666666666666
2020,PA-512,York City & County CoC,370,16,354,677.0,824.9166666666666
2020,PA-600,"Pittsburgh, McKeesport, Penn Hills/Allegheny County CoC",887,183,704,715.0,697.0
2020,PA-601,Western Pennsylvania CoC,754,24,730,624.1388888888888,593.9236111111112
2020,PA-603,Beaver County CoC,101,6,95,715.0,572.5
2020,PA-605,Erie City & County CoC,348,38,310,620.0,551.3333333333334
2020,PR-502,Puerto Rico Balance of Commonwealth CoC,1299,363,936,408.3235294117647,423.02941176470586
2020,PR-503,South-Southeast Puerto Rico CoC,1152,305,847,418.61764705882354,413.2647058823529
2020,RI-500,Rhode Island Statewide CoC,1104,226,878,852.5,1120.9371428571428
2020,SC-500,Charleston/Low Country CoC,433,88,345,753.1190476190477,699.0744047619048
2020,SC-501,"Greenville, Anderson, Spartanburg/Upstate CoC",1536,353,1183,598.9477777777778,635.2988888888889
2020,SC-502,Columbia/Midlands CoC,1140,271,869,620.1218820861678,743.8835034013606
2020,SC-503,"Myrtle Beach, Sumter City & County CoC",1178,152,1026,655.8863636363636,726.8409090909091
2020,SD-500,South Dakota Statewide CoC,1058,162,896,548.3052066980638,512.7233124018838
2020,TN-500,Chattanooga/Southeast Tennessee CoC,648,168,480,546.1706349206349,544.2936507936508
2020,TN-501,Memphis/Shelby County CoC,1022,21,1001,710.0,639.3333333333334
2020,TN-502,Knoxville/Knox County CoC,745,197,548,670.0,567.4285714285714
2020,TN-503,Central Tennessee CoC,517,16,501,697.0226190476191,637.7625
2020,TN-504,Nashville-Davidson County CoC,2016,533,1483,967.0,884.0
2020,TN-506,Upper Cumberland CoC,332,0,332,688.8984126984126,671.1832199546486
2020,TN-507,Jackson/West Tennessee CoC,861,71,790,563.1011904761905,543.9190476190477
2020,TN-509,Appalachian Regional CoC,386,85,301,531.6785714285714,599.125
2020,TN-510,Murfreesboro/Rutherford County CoC,322,51,271,967.0,802.0
2020,TN-512,"Morristown/Blount, Sevier, Campbell, Cocke Counties CoC",407,11,396,555.7295918367347,523.0619047619048
2020,TX-500,San Antonio/Bexar County CoC,2932,293,2639,755.0,707.7142857142857
2020,TX-503,Austin/Travis County CoC,2506,787,1719,1062.0,905.1666666666666
2020,TX-600,"Dallas City & County, Irving CoC",4471,505,3966,1046.0,819.3333333333333
2020,TX-601,"Fort Worth, Arlington/Tarrant County CoC",2126,247,1879,893.0,811.8666666666667
2020,TX-603,El Paso City & County CoC,843,102,741,581.0,574.25
2020,TX-604,Waco/McLennan County CoC,234,29,205,547.4333333333334,637.6666666666667
2020,TX-607,Texas Balance of State CoC,9198,1178,8020,668.1684371184372,669.7130054585936
2020,TX-624,"Wichita Falls/Wise, Palo Pinto, Wichita, Archer Counties CoC",236,18,218,649.5035714285714,611.4547619047619
2020,TX-700,"Houston, Pasadena, Conroe/Harris, Ft. Bend, Montgomery, Counties CoC",3974,800,3174,888.0,697.1153846153846
2020,TX-701,"Bryan, College Station/Brazos Valley CoC",109,10,99,597.6358974358974,694.1589743589743
2020,UT-500,Salt Lake City & County CoC,1958,436,1522,839.0,697.3333333333333
2020,UT-503,Utah Balance of State CoC,1006,203,803,599.9444444444443,675.8284722222222
2020,UT-504,Provo/Mountainland CoC,167,49,118,861.7666666666668,647.0333333333333
2020,VA-500,"Richmond/Henrico, Chesterfield, Hanover Counties CoC",546,137,409,963.0,891.4270833333334
2020,VA-501,"Norfolk, Chesapeake, Suffolk/Isle of Wight, Southampton Counties CoC",709,53,656,903.1547619047619,841.4642857142858
2020,VA-502,"Roanoke City & County, Salem CoC",276,44,232,572.1388888888888,591.3472222222222
2020,VA-503,Virginia Beach CoC,319,51,268,1025.0,987.0
2020,VA-504,Charlottesville CoC,188,46,142,882.8181818181818,708.0530303030303
2020,VA-505,"Newport News, Hampton/Virginia Peninsula CoC",425,52,373,1025.0,914.4444444444445
2020,VA-508,Lynchburg CoC,73,7,66,674.0,669.1666666666666
2020,VA-513,"Harrisburg, Winchester/Western Virginia CoC",297,47,250,687.2579365079364,763.2142857142857
2020,VA-514,"Fredericksburg/Spotsylvania, Stafford Counties CoC",207,21,186,927.8,832.2
2020,VA-521,Virginia Balance of State CoC,816,28,788,615.5957473082474,683.3208753052503
2020,VA-603,Alexandria CoC,207,24,183,1593.0,1540.0
2020,VT-500,Vermont Balance of State CoC,849,135,714,853.3892857142857,784.3898809523808
2020,VT-501,Burlington/Chittenden County CoC,261,50,211,1095.0,714.5333333333333
2020,WA-500,Seattle/King County CoC,11751,3355,8396,1738.0,1026.111111111111
2020,WA-501,Washington Balance of State CoC,5668,1541,4127,699.0208333333334,952.28125
2020,WA-502,Spokane City & County CoC,1559,485,1074,631.0,567.7916666666667
2020,WA-503,"Tacoma, Lakewood/Pierce County CoC",1897,646,1251,1033.0,1111.875
2020,WA-504,Everett/Snohomish County CoC,1132,532,600,1738.0,1107.75
2020,WI-500,Wisconsin Balance of State CoC,2708,376,2332,629.3910804789753,669.5341130604288
2020,WI-501,Milwaukee City & County CoC,970,73,897,664.0,669.75
2020,WI-502,Racine City & County CoC,207,14,193,605.0,689.5833333333334
2020,WI-503,Madison/Dane County CoC,630,148,482,918.0,613.7142857142857
2020,WV-500,"Wheeling, Weirton Area CoC",129,20,109,532.6083333333333,622.15
2020,WV-501,"Huntington/Cabell, Wayne Counties CoC",194,4,190,589.0,527.5833333333333
2020,WV-503,"Charleston/Kanawha, Putnam, Boone, Clay Counties CoC",294,31,263,620.5294117647059,537.6176470588235
2020,WV-508,West Virginia Balance of State CoC,724,119,605,611.7210396466279,557.4819803562451
2020,WY-500,Wyoming Statewide CoC,612,81,531,687.4477272727272,654.143777056277
2019,AK-500,Anchorage CoC,1111,91,1020,989.0,777.0
2019,AK-501,Alaska Balance of State CoC,796,178,618,803.0,978.0
2019,AL-500,"Birmingham/Jefferson, St. Clair, Shelby Counties CoC",981,101,880,763.0,632.3888888888889
2019,AL-501,Mobile City & County/Baldwin County CoC,505,43,462,765.95,612.225
2019,AL-502,Florence/Northwest Alabama CoC,390,21,369,522.9,502.1333333333334
2019,AL-503,Huntsville/North Alabama CoC,464,96,368,601.25,479.9375
2019,AL-504,Montgomery City & County CoC,330,62,268,604.8125,505.4375
2019,AL-506,Tuscaloosa City & County CoC,44,0,44,699.0,652.8333333333333
2019,AL-507,Alabama Balance of State CoC,323,16,307,533.1253582202112,628.948661387632
2019,AR-500,Little Rock/Central Arkansas CoC,1066,296,770,615.1666666666667,535.5
2019,AR-501,Fayetteville/Northwest Arkansas CoC,518,120,398,562.9333333333333,495.78888888888895
2019,AR-503,Arkansas  Balance of State  CoC,811,177,634,525.9001960784315,547.8783333333333
2019,AR-505,Southeast Arkansas CoC,75,0,75,512.1942857142857,533.9166666666666
2019,AZ-500,Arizona Balance of State CoC,2021,558,1463,626.5208333333333,649.125
2019,AZ-501,Tucson/Pima County CoC,1372,356,1016,617.0,688.6
2019,AZ-502,"Phoenix, Mesa/Maricopa County CoC",6614,962,5652,797.0,623.5
2019,CA-500,San Jose/Santa Clara City & County CoC,9706,2471,7235,2062.0,1318.1666666666667
2019,CA-501,San Francisco CoC,8035,3030,5005,2155.0,1919.5
2019,CA-502,"Oakland, Berkeley/Alameda County CoC",8022,2236,5786,1562.0,1554.6666666666667
2019,CA-503,Sacramento City & County CoC,5561,1641,3920,916.0,906.5
2019,CA-504,"Santa Rosa, Petaluma/Sonoma County CoC",2951,675,2276,1334.0,1206.1666666666667
2019,CA-505,Richmond/Contra Costa County CoC,2295,504,1791,1562.0,1387.857142857143
2019,CA-506,"Salinas/Monterey, San Benito Counties CoC",2704,641,2063,1298.0,1062.0
2019,CA-507,Marin County CoC,1034,257,777,2155.0,1515.25
2019,CA-508,Watsonville/Santa Cruz City & County CoC,2167,403,1764,1682.0,1756.5
2019,CA-509,Mendocino County CoC,785,123,662,803.0,764.3
2019,CA-510,"Turlock, Modesto/Stanislaus County CoC",1923,285,1638,764.0,1091.2666666666667
2019,CA-511,Stockton/San Joaquin County CoC,2631,742,1889,743.0,1121.7
2019,CA-512,Daly/San Mateo County CoC,1512,321,1191,2155.0,1765.0
2019,CA-513,"Visalia/Kings, Tulare Counties CoC",1064,315,749,793.2,869.6
2019,CA-514,Fresno City & County/Madera County CoC,2508,698,1810,750.7,809.7333333333333
2019,CA-515,"Roseville, Rocklin/Placer County CoC",617,238,379,916.0,744.0
2019,CA-516,"Redding/Shasta, Siskiyou, Lassen, Plumas, Del Norte, Modoc, Sierra Counties CoC",1349,318,1031,688.7407407407408,681.5555555555555
2019,CA-517,Napa City & County CoC,322,149,173,1177.0,942.25
2019,CA-518,Vallejo/Solano County CoC,1151,179,972,1052.0,1326.6666666666667
2019,CA-519,"Chico, Paradise/Butte County CoC",1266,256,1010,859.0,630.0
2019,CA-520,Merced City & County CoC,608,195,413,613.0,1090.4
2019,CA-521,"Davis, Woodland/Yolo County CoC",655,175,480,1036.0,790.0
2019,CA-522,Humboldt County CoC,1702,474,1228,710.0,664.0
2019,CA-523,"Colusa, Glenn, Trinity Counties CoC",192,46,146,622.375,709.9375
2019,CA-524,Yuba City & County/Sutter County CoC,721,237,484,711.0,777.1428571428571
2019,CA-525,El Dorado County CoC,613,111,502,916.0,749.2
2019,CA-526,"Amador, Calaveras, Mariposa, Tuolumne Counties CoC",845,264,581,758.404761904762,731.4642857142857
2019,CA-600,Los Angeles City & County CoC,56257,15538,40719,1251.0,1033.75
2019,CA-601,San Diego City and County CoC,8102,1712,6390,1422.0,944.6666666666666
2019,CA-602,"Santa Ana, Anaheim/Orange County CoC",6860,2562,4298,1534.0,1019.25
2019,CA-603,Santa Maria/Santa Barbara County CoC,1803,423,1380,1480.0,979.0
2019,CA-604,Bakersfield/Kern County CoC,1330,73,1257,750.0,1030.5
2019,CA-608,Riverside City & County CoC,2811,804,2007,895.0,936.2
2019,CA-609,San Bernardino City & County CoC,2607,767,1840,895.0,882.5714285714286
2019,CA-611,"Oxnard, San Buenaventura/Ventura County CoC",1669,324,1345,1237.0,1113.6666666666667
2019,CA-613,Imperial County CoC,1413,490,923,644.0,900.0
2019,CA-614,San Luis Obispo County CoC,1483,298,1185,1130.0,1012.0
2019,CO-500,Colorado Balance of State CoC,2302,693,1609,704.5146231546231,624.5791258741259
2019,CO-503,Metropolitan Denver CoC,5755,1158,4597,1143.0641025641025,745.7371794871796
2019,CO-504,Colorado Springs/El Paso County CoC,1562,336,1226,736.0,865.3
2019,CT-503,"Bridgeport, Stamford, Norwalk, Danbury/Fairfield County CoC",771,56,715,1120.9130434782608,1228.0
2019,CT-505,Connecticut Balance of State CoC,2262,158,2104,811.021693121693,972.8225155279504
2019,DE-500,Delaware Statewide CoC,921,168,753,876.3095238095237,841.8809523809523
2019,FL-500,"Sarasota, Bradenton/Manatee, Sarasota Counties CoC",1135,246,889,870.0,690.5833333333334
2019,FL-501,Tampa/Hillsborough County CoC,1650,264,1386,917.0,747.0
2019,FL-502,"St. Petersburg, Clearwater, Largo/Pinellas County CoC",2415,722,1693,917.0,817.0
2019,FL-503,"Lakeland, Winterhaven/Polk County CoC",563,80,483,750.0,780.6666666666666
2019,FL-504,"Deltona, Daytona Beach/Volusia, Flagler Counties CoC",875,89,786,802.0,733.8333333333334
2019,FL-505,"Fort Walton Beach/Okaloosa, Walton Counties CoC",399,269,130,844.5,602.75
2019,FL-506,Tallahassee/Leon County CoC,966,152,814,636.5092592592592,572.0092592592592
2019,FL-507,"Orlando/Orange, Osceola, Seminole Counties CoC",2010,478,1532,990.0,686.8333333333334
2019,FL-508,"Gainesville/Alachua, Putnam Counties CoC",804,261,543,646.0833333333334,649.1666666666666
2019,FL-509,"Fort Pierce/St. Lucie, Indian River, Martin Counties CoC",1499,51,1448,769.9,782.05
2019,FL-510,"Jacksonville-Duval, Clay Counties CoC",1654,301,1353,680.0,632.3333333333334
2019,FL-511,"Pensacola/Escambia, Santa Rosa Counties CoC",518,52,466,840.0,743.6666666666666
2019,FL-512,St. Johns County CoC,356,14,342,680.0,710.3333333333334
2019,FL-513,"Palm Bay, Melbourne/Brevard County CoC",815,206,609,680.0,722.0
2019,FL-514,Ocala/Marion County CoC,475,150,325,670.0,659.4444444444445
2019,FL-515,"Panama City/Bay, Jackson Counties CoC",488,34,454,520.375,642.25
2019,FL-517,"Hendry, Hardee, Highlands Counties CoC",398,235,163,662.705,814.24
2019,FL-518,"Columbia, Hamilton, Lafayette, Suwannee Counties CoC",538,41,497,634.5500000000001,588.7833333333333
2019,FL-519,Pasco County CoC,894,265,629,917.0,757.625
2019,FL-520,"Citrus, Hernando, Lake, Sumter Counties CoC",677,68,609,836.1388888888888,707.6666666666666
2019,FL-600,Miami-Dade County CoC,3472,378,3094,1019.0,937.3333333333334
2019,FL-601,Ft Lauderdale/Broward County CoC,2803,914,1889,1011.0,832.75
2019,FL-602,Punta Gorda/Charlotte County CoC,156,48,108,798.0,722.0
2019,FL-603,"Ft Myers, Cape Coral/Lee County CoC",372,99,273,829.0,718.1666666666666
2019,FL-604,Monroe County CoC,501,36,465,1162.0,881.0
2019,FL-605,West Palm Beach/Palm Beach County CoC,1397,215,1182,1029.0,809.2222222222222
2019,FL-606,Naples/Collier County CoC,498,61,437,925.0,864.2
2019,GA-500,Atlanta CoC,3217,376,2841,1005.0,930.0
2019,GA-501,Georgia Balance of State CoC,4183,296,3887,714.1897923875433,669.5373125720878
2019,GA-503,Athens-Clarke County CoC,237,38,199,666.0,702.8
2019,GA-504,Augusta-Richmond County CoC,384,42,342,742.0,647.8333333333334
2019,GA-505,Columbus-Muscogee CoC,278,20,258,694.0,638.5
2019,GA-506,Marietta/Cobb County CoC,451,63,388,1005.0,930.0
2019,GA-507,Savannah/Chatham County CoC,686,182,504,885.0,781.1666666666667
2019,GA-508,DeKalb County CoC,375,43,332,1005.0,930.0
2019,IA-500,"Sioux City/Dakota, Woodbury Counties CoC",255,21,234,567.0,486.6333333333333
2019,IA-501,Iowa Balance of State CoC,1379,215,1164,519.7832500832501,529.2061716061716
2019,IA-502,Des Moines/Polk County CoC,681,104,577,655.0,593.5714285714286
2019,ID-500,Boise/Ada County CoC,713,227,486,587.0,566.8
2019,ID-501,Idaho Balance of State CoC,1602,222,1380,549.4562500000001,581.0430555555556
2019,IL-500,McHenry County CoC,159,16,143,998.0,812.9
2019,IL-501,"Rockford/DeKalb, Winnebago, Boone Counties CoC",403,28,375,638.4,805.8
2019,IL-502,"Waukegan, North Chicago/Lake County CoC",252,28,224,998.0,776.6666666666666
2019,IL-503,"Champaign, Urbana, Rantoul/Champaign County CoC",151,10,141,727.0,554.875
2019,IL-506,"Joliet, Bolingbrook/Will County CoC",278,18,260,995.6428571428571,748.5714285714286
2019,IL-507,"Peoria, Pekin/Fulton, Tazewell, Peoria, Woodford Counties CoC",285,48,237,577.0,526.3888888888888
2019,IL-511,Cook County CoC,897,142,755,998.0,844.4285714285714
2019,IL-512,Bloomington/Central Illinois CoC,319,49,270,574.2142857142858,588.1111111111112
2019,IL-513,Springfield/Sangamon County CoC,284,59,225,606.0,511.0
2019,IL-514,DuPage County CoC,309,31,278,998.0,963.1666666666666
2019,IL-515,South Central Illinois CoC,94,3,91,540.6432098765431,546.104938271605
2019,IL-516,Decatur/Macon County CoC,169,25,144,508.0,553.0
2019,IL-517,"Aurora, Elgin/Kane County CoC",388,126,262,998.0,908.8
2019,IL-518,"Rock Island, Moline/Northwestern Illinois CoC",211,2,209,528.3775510204082,578.1190476190476
2019,IL-519,West Central Illinois CoC,68,3,65,491.3142857142857,506.11292517006797
2019,IL-520,Southern Illinois CoC,294,18,276,512.0416666666667,510.0673611111111
2019,IN-502,Indiana Balance of State CoC,3904,241,3663,585.3804481792718,628.6720448179271
2019,IN-503,Indianapolis CoC,1567,125,1442,692.0,638.0
2019,KS-502,Wichita/Sedgwick County CoC,593,20,573,535.0,505.5
2019,KS-503,Topeka/Shawnee County CoC,441,192,249,576.0,596.8333333333334
2019,KS-507,Kansas Balance of State CoC,1056,100,956,548.4850982350981,544.9002664002663
2019,KY-500,Kentucky Balance of State CoC,2221,202,2019,524.5145124716553,527.5503401360545
2019,KY-501,Louisville-Jefferson County CoC,1071,220,851,641.0,601.8
2019,KY-502,Lexington-Fayette County CoC,787,112,675,661.0,594.3333333333334
2019,LA-500,Lafayette/Acadiana CoC,360,75,285,555.051282051282,550.2051282051282
2019,LA-502,"Shreveport, Bossier/Northwest Louisiana CoC",292,43,249,572.9305555555555,563.4861111111111
2019,LA-503,New Orleans/Jefferson Parish CoC,1179,146,1033,769.0,749.5
2019,LA-505,Monroe/Northeast Louisiana CoC,188,20,168,533.502380952381,546.3285714285714
2019,LA-506,Slidell/Southeast Louisiana CoC,215,18,197,722.8229166666666,652.7916666666666
2019,LA-507,Alexandria/Central Louisiana CoC,114,21,93,539.9007936507936,544.6646825396825
2019,LA-509,Louisiana Balance of State CoC,593,123,470,677.8209134615385,622.7916666666666
2019,MA-500,Boston CoC,6242,825,5417,1700.0,1245.1767818238407
2019,MA-503,Cape Cod Islands CoC,371,62,309,1097.75,1022.574074074074
2019,MA-504,Springfield/Hampden County CoC,2443,200,2243,739.0,849.1236111111111
2019,MA-506,Worcester City & County CoC,1593,84,1509,916.6499999999999,893.0433399166119
2019,MA-507,"Pittsfield/Berkshire, Franklin, Hampshire Counties CoC",546,74,472,901.3216145833334,814.8041666666667
2019,MA-511,"Quincy, Brockton, Weymouth, Plymouth City and County CoC",1088,212,876,1387.851851851852,1148.6785714285716
2019,MA-516,Massachusetts Balance of State CoC,3589,503,3086,1611.333618632638,982.3945646106937
2019,MA-519,"Attleboro, Taunton/Bristol County CoC",256,14,242,859.75,1120.0906084656085
2019,MD-501,Baltimore CoC,2294,619,1675,931.0,918.0
2019,MD-503,Annapolis/Anne Arundel County CoC,302,71,231,931.0,899.3333333333334
2019,MD-505,Baltimore County CoC,735,183,552,931.0,865.3333333333334
2019,MD-506,Carroll County CoC,144,44,100,931.0,745.0
2019,MD-511,Mid-Shore Regional CoC,164,23,141,850.4,837.3333333333334
2019,MD-513,"Wicomico, Somerset, Worcester Counties CoC",275,48,227,698.3333333333334,781.6666666666666
2019,MD-514,Maryland Balance of State CoC,1352,214,1138,819.7310606060607,720.185606060606
2019,ME-500,Maine Statewide CoC,2106,226,1880,845.7379310344826,841.3135135135135
2019,MI-500,Michigan Balance of State CoC,1298,81,1217,587.800279106858,612.8786483253589
2019,MI-502,"Dearborn, Dearborn Heights, Westland/Wayne County CoC",222,21,201,665.0,728.0
2019,MI-503,"St. Clair Shores, Warren/Macomb County CoC",265,12,253,665.0,644.0
2019,MI-504,"Pontiac, Royal Oak/Oakland County CoC",425,47,378,665.0,680.5
2019,MI-505,Flint/Genesee County CoC,450,51,399,515.0,595.5833333333334
2019,MI-506,"Grand Rapids, Wyoming/Kent County CoC",759,121,638,657.0,592.3333333333334
2019,MI-507,"Portage, Kalamazoo City & County CoC",702,89,613,576.0,548.6666666666667
2019,MI-508,"Lansing, East Lansing/Ingham County CoC",476,40,436,703.0,621.625
2019,MI-509,Washtenaw County CoC,273,58,215,972.0,638.0
2019,MI-510,Saginaw City & County CoC,364,25,339,547.0,517.7
2019,MI-511,Lenawee County CoC,123,6,117,533.0,627.1666666666666
2019,MI-512,"Grand Traverse, Antrim, Leelanau Counties CoC",168,44,124,598.6770833333333,546.7708333333333
2019,MI-514,Battle Creek/Calhoun County CoC,241,38,203,513.0,592.4375
2019,MI-515,Monroe City & County CoC,167,5,162,689.0,666.0
2019,MI-516,"Norton Shores, Muskegon City & County CoC",136,14,122,645.0,612.0
2019,MI-517,Jackson City & County CoC,113,7,106,653.0,644.1428571428571
2019,MI-518,Livingston County CoC,89,7,82,690.0,649.0
2019,MI-519,Holland/Ottawa County CoC,225,5,220,782.0,620.2
2019,MI-523,Eaton County CoC,114,0,114,703.0,578.0833333333334
2019,MN-500,Minneapolis/Hennepin County CoC,3400,758,2642,823.0,760.0
2019,MN-501,Saint Paul/Ramsey County CoC,1579,456,1123,823.0,760.0
2019,MN-502,Rochester/Southeast Minnesota CoC,452,46,406,533.5630341880342,560.3803418803418
2019,MN-503,"Dakota, Anoka, Washington, Scott, Carver Counties",686,130,556,823.0,674.8472222222223
2019,MN-504,Northeast Minnesota CoC,90,6,84,538.7504761904762,551.4095238095239
2019,MN-505,St. Cloud/Central Minnesota CoC,679,143,536,688.7993197278912,596.0816326530612
2019,MN-506,Northwest Minnesota CoC,268,27,241,515.0666666666667,531.325
2019,MN-508,Moorhead/West Central Minnesota CoC,216,16,200,480.1933333333333,505.36
2019,MN-509,Duluth/St.Louis County CoC,519,155,364,670.0,558.4
2019,MN-511,Southwest Minnesota CoC,88,8,80,513.044658119658,555.4418803418804
2019,MO-500,St. Louis County CoC,487,43,444,680.0,651.0
2019,MO-501,St.Louis City CoC,1031,191,840,680.0,651.0
2019,MO-503,"St. Charles City & County, Lincoln, Warren Counties CoC",438,29,409,680.0,606.0555555555555
2019,MO-600,"Springfield/Greene, Christian, Webster Counties CoC",492,121,371,582.0,464.8333333333333
2019,MO-602,"Joplin/Jasper, Newton Counties CoC",237,32,205,553.0,508.77777777777777
2019,MO-603,"St. Joseph/Andrew, Buchanan, DeKalb Counties CoC",255,92,163,566.0,534.1666666666666
2019,MO-606,Missouri Balance of State CoC,1362,272,1090,499.0002526500796,546.8886266271213
2019,MS-500,"Jackson/Rankin, Madison Counties CoC",408,173,235,645.3684210526316,508.9824561403509
2019,MS-501,Mississippi Balance of State CoC,480,31,449,530.0458357432042,582.720623674571
2019,MS-503,Gulf Port/Gulf Coast Regional CoC,296,19,277,627.4285714285714,686.1428571428571
2019,MT-500,Montana Statewide CoC,1357,228,1129,540.3757575757576,565.3
2019,NC-500,Winston-Salem/Forsyth County CoC,454,78,376,597.0,623.5833333333333
2019,NC-501,Asheville/Buncombe County CoC,580,123,457,870.0,592.6666666666667
2019,NC-502,Durham City & County CoC,361,82,279,893.0,738.0
2019,NC-503,North Carolina Balance of State CoC,2989,299,2690,659.7352632661456,642.0778184560538
2019,NC-504,"Greensboro, High Point CoC",586,44,542,654.0,603.8
2019,NC-505,Charlotte/Mecklenberg CoC,1742,247,1495,940.0,686.9444444444445
2019,NC-506,"Wilmington/Brunswick, New Hanover, Pender Counties CoC",431,49,382,715.3333333333333,700.5833333333333
2019,NC-507,Raleigh/Wake County CoC,970,126,844,905.0,744.1666666666667
2019,NC-509,"Gastonia/Cleveland, Gaston, Lincoln Counties CoC",324,60,264,681.6999999999999,650.2666666666667
2019,NC-511,Fayetteville/Cumberland County CoC,329,122,207,805.0,587.8333333333334
2019,NC-513,Chapel Hill/Orange County CoC,131,24,107,893.0,690.75
2019,NC-516,Northwest North Carolina CoC,417,17,400,545.2019230769231,574.3543956043956
2019,ND-500,North Dakota Statewide CoC,557,73,484,604.9493371212121,475.85227272727275
2019,NE-500,Nebraska Balance of State CoC,506,11,495,530.1142170329671,556.6023809523809
2019,NE-501,"Omaha, Council Bluffs CoC",1410,343,1067,663.0,575.5
2019,NE-502,Lincoln CoC,449,100,349,613.0,495.125
2019,NH-500,New Hampshire Balance of State CoC,669,167,502,849.1396396396398,879.2124390208438
2019,NH-502,Nashua/Hillsborough County CoC,266,14,252,886.9354838709677,1001.1754018724608
2019,NJ-500,Atlantic City & County CoC,357,73,284,917.0,907.0
2019,NJ-501,Bergen County CoC,271,11,260,1202.0,1393.8333333333333
2019,NJ-502,Burlington County CoC,518,36,482,908.0,935.4285714285714
2019,NJ-503,"Camden City & County/Gloucester, Cape May, Cumberland Counties CoC",979,230,749,895.1666666666666,881.0416666666666
2019,NJ-504,Newark/Essex County CoC,2235,271,1964,1118.0,1182.2
2019,NJ-506,"Jersey City, Bayonne/Hudson County CoC",890,226,664,1278.0,1253.25
2019,NJ-507,New Brunswick/Middlesex County CoC,620,131,489,1224.0,1154.0
2019,NJ-508,Monmouth County CoC,359,58,301,1014.0,1118.8
2019,NJ-509,Morris County CoC,388,65,323,1118.0,1100.8
2019,NJ-510,Lakewood Township/Ocean County CoC,305,38,267,1014.0,942.3333333333334
2019,NJ-511,Paterson/Passaic County CoC,391,93,298,1202.0,1173.6666666666667
2019,NJ-513,Somerset County CoC,301,7,294,1224.0,1058.8
2019,NJ-514,Trenton/Mercer County CoC,448,70,378,974.0,1013.3333333333334
2019,NJ-515,Elizabeth/Union County CoC,437,68,369,1118.0,1213.6666666666667
2019,NJ-516,"Warren, Sussex, Hunterdon Counties CoC",334,41,293,1136.904761904762,1005.75
2019,NM-501,New Mexico Balance of State CoC,1717,865,852,624.0756673881674,552.5818903318903
2019,NV-500,Las Vegas/Clark County CoC,5530,622,4908,694.0,684.75
2019,NV-501,"Reno, Sparks/Washoe County CoC",1256,76,1180,712.0,671.1
2019,NV-502,Nevada Balance of State CoC,383,17,366,595.5652557319224,659.402557319224
2019,NY-500,"Rochester, Irondequoit, Greece/Monroe County CoC",849,97,752,690.0,655.0
2019,NY-501,"Elmira/Steuben, Allegany, Livingston, Chemung, Schuyler Counties CoC",240,3,237,628.55,631.5
2019,NY-503,Albany City & County CoC,750,91,659,821.0,734.9
2019,NY-505,"Syracuse, Auburn/Onondaga, Oswego, Cayuga Counties CoC",732,30,702,610.0666666666667,729.0
2019,NY-507,Schenectady City & County CoC,372,24,348,821.0,730.5
2019,NY-508,"Buffalo, Niagara Falls/Erie, Niagara, Orleans, Genesee, Wyoming Counties CoC",924,31,893,617.4583333333334,608.4166666666666
2019,NY-510,Ithaca/Tompkins County CoC,171,55,116,996.0,608.875
2019,NY-511,"Binghamton, Union Town/Broome, Otsego, Chenango, Delaware, Cortland, Tioga Count",318,0,318,641.90625,700.06875
2019,NY-512,Troy/Rensselaer County CoC,199,9,190,821.0,779.775
2019,NY-513,"Wayne, Ontario, Seneca, Yates Counties CoC",205,149,56,687.35,711.65
2019,NY-514,"Jamestown, Dunkirk/Chautauqua County CoC",96,2,94,579.0,606.75
2019,NY-518,"Utica, Rome/Oneida, Madison Counties CoC",168,6,162,606.5833333333334,636.5
2019,NY-519,"Columbia, Greene Counties CoC",200,20,180,690.0,783.8392857142857
2019,NY-520,"Franklin, Essex Counties CoC",24,0,24,617.3,745.5
2019,NY-522,"Jefferson, Lewis, St. Lawrence Counties CoC",53,0,53,660.1333333333333,612.0666666666667
2019,NY-523,"Glens Falls, Saratoga Springs/Saratoga, Washington, Warren, Hamilton Counties Co",268,43,225,745.0,703.452380952381
2019,NY-600,New York City CoC,78604,6226,72378,1700.0,1211.7142857142858
2019,NY-601,Poughkeepsie/Dutchess County CoC,533,31,502,1030.0,990.0939440993789
2019,NY-602,"Newburgh, Middletown/Orange County CoC",589,57,532,1030.0,1125.0714285714287
2019,NY-603,"Nassau, Suffolk Counties CoC",3843,109,3734,1337.0,1198.2845640671726
2019,NY-604,"Yonkers, Mount Vernon/Westchester County CoC",1812,130,1682,1524.5,1442.463768115942
2019,NY-606,Rockland County CoC,182,36,146,1700.0,1314.0
2019,NY-608,Kingston/Ulster County CoC,432,25,407,823.0,790.3
2019,OH-500,Cincinnati/Hamilton County CoC,1082,69,1013,629.0,583.6666666666666
2019,OH-501,Toledo/Lucas County CoC,611,48,563,506.0,596.75
2019,OH-502,Cleveland/Cuyahoga County CoC,1618,226,1392,607.0,571.8
2019,OH-503,Columbus/Franklin County CoC,1907,97,1810,688.0,638.1666666666666
2019,OH-504,Youngstown/Mahoning County CoC,148,18,130,501.0,525.0555555555555
2019,OH-505,"Dayton, Kettering/Montgomery County CoC",681,28,653,556.0,549.1428571428571
2019,OH-506,"Akron, Barberton/Summit County CoC",546,54,492,564.0,546.0
2019,OH-507,Ohio Balance of State CoC,3479,330,3149,543.60756821247,558.4551379811184
2019,OH-508,"Canton, Massillon, Alliance/Stark County CoC",273,4,269,538.0,536.6666666666666
2019,OK-500,North Central Oklahoma CoC,178,3,175,577.4333333333334,531.1333333333334
2019,OK-501,Tulsa City & County CoC,1188,236,952,606.0,540.0
2019,OK-502,Oklahoma City CoC,1273,275,998,678.0,613.8333333333333
2019,OK-503,Oklahoma Balance of State CoC,279,80,199,547.3759496676163,560.5478395061727
2019,OK-504,Norman/Cleveland County CoC,347,290,57,678.0,653.0
2019,OK-505,Northeast Oklahoma CoC,228,28,200,538.8537414965986,547.0680272108843
2019,OK-506,Southwest Oklahoma Regional CoC,158,9,149,517.3958333333334,564.84375
2019,OK-507,Southeastern Oklahoma Regional CoC,293,33,260,508.6208333333334,552.3604166666667
2019,OR-500,"Eugene, Springfield/Lane County CoC",2165,841,1324,715.0,674.8
2019,OR-501,"Portland, Gresham/Multnomah County CoC",4015,1781,2234,1193.0,1056.0
2019,OR-502,"Medford, Ashland/Jackson County CoC",712,196,516,726.0,577.8333333333333
2019,OR-503,Central Oregon CoC,880,160,720,623.0333333333333,600.6333333333333
2019,OR-505,Oregon Balance of State CoC,7103,1603,5500,678.0355324074075,742.0409722222222
2019,OR-506,"Hillsboro, Beaverton/Washington County CoC",530,139,391,1193.0,1040.1666666666667
2019,OR-507,Clackamas County CoC,471,182,289,1193.0,932.5833333333334
2019,PA-500,Philadelphia CoC,5735,1304,4431,908.0,883.0
2019,PA-501,Harrisburg/Dauphin County CoC,418,64,354,692.0,662.6111111111112
2019,PA-502,"Upper Darby, Chester, Haverford/Delaware County CoC",400,21,379,908.0,883.0
2019,PA-503,"Wilkes-Barre, Hazleton/Luzerne County CoC",164,2,162,576.0,625.75
2019,PA-504,"Lower Merion, Norristown, Abington/Montgomery County CoC",246,31,215,908.0,810.3333333333334
2019,PA-505,Chester County CoC,528,19,509,908.0,809.6666666666666
2019,PA-506,Reading/Berks County CoC,597,38,559,707.0,787.0833333333334
2019,PA-508,Scranton/Lackawanna County CoC,186,12,174,576.0,633.375
2019,PA-509,Eastern Pennsylvania CoC,1843,142,1701,700.5802083333334,728.8833333333333
2019,PA-510,Lancaster City & County CoC,422,16,406,775.0,749.25
2019,PA-511,"Bristol, Bensalem/Bucks County CoC",359,35,324,908.0,890.3333333333334
2019,PA-512,York City & County CoC,321,13,308,653.0,812.0
2019,PA-600,"Pittsburgh, McKeesport, Penn Hills/Allegheny County CoC",774,111,663,697.0,667.0
2019,PA-601,Western Pennsylvania CoC,727,17,710,600.8263888888889,587.1736111111111
2019,PA-603,Beaver County CoC,123,0,123,697.0,559.3333333333334
2019,PA-605,Erie City & County CoC,356,38,318,648.0,549.5
2019,PR-502,Puerto Rico Balance of Commonwealth CoC,1345,363,982,413.2647058823529,401.47058823529414
2019,PR-503,South-Southeast Puerto Rico CoC,1190,323,867,423.02941176470586,391.97058823529414
2019,RI-500,Rhode Island Statewide CoC,1055,198,857,845.9,1063.42
2019,SC-500,Charleston/Low Country CoC,403,86,317,729.702380952381,690.8333333333334
2019,SC-501,"Greenville, Anderson, Spartanburg/Upstate CoC",1401,321,1080,601.6433333333333,612.5688888888889
2019,SC-502,Columbia/Midlands CoC,1215,277,938,615.1893424036281,673.7590702947846
2019,SC-503,"Myrtle Beach, Sumter City & County CoC",1153,258,895,658.3948863636364,694.3039772727273
2019,SD-500,South Dakota Statewide CoC,995,100,895,529.2059458398744,500.8142006802721
2019,TN-500,Chattanooga/Southeast Tennessee CoC,463,91,372,515.5793650793651,520.7619047619047
2019,TN-501,Memphis/Shelby County CoC,1325,74,1251,704.0,625.8333333333334
2019,TN-502,Knoxville/Knox County CoC,800,176,624,605.0,546.9285714285714
2019,TN-503,Central Tennessee CoC,357,75,282,644.7339285714286,591.4955357142858
2019,TN-504,Nashville-Davidson County CoC,1986,466,1520,884.0,777.0
2019,TN-506,Upper Cumberland CoC,273,24,249,641.0562358276644,622.2702947845804
2019,TN-507,Jackson/West Tennessee CoC,959,96,863,543.247619047619,536.6273809523809
2019,TN-509,Appalachian Regional CoC,405,51,354,498.34523809523813,568.0416666666667
2019,TN-510,Murfreesboro/Rutherford County CoC,384,41,343,884.0,713.9166666666666
2019,TN-512,"Morristown/Blount, Sevier, Campbell, Cocke Counties CoC",515,39,476,510.07721088435375,514.3857142857142
2019,TX-500,San Antonio/Bexar County CoC,2872,343,2529,738.0,663.5714285714286
2019,TX-503,Austin/Travis County CoC,2255,602,1653,1004.0,851.8333333333334
2019,TX-600,"Dallas City & County, Irving CoC",4538,533,4005,905.0,760.3888888888889
2019,TX-601,"Fort Worth, Arlington/Tarrant County CoC",2028,320,1708,805.0,741.4666666666667
2019,TX-603,El Paso City & County CoC,809,123,686,576.0,565.5
2019,TX-604,Waco/McLennan County CoC,193,35,158,535.8333333333333,620.8333333333333
2019,TX-607,Texas Balance of State CoC,8072,597,7475,651.3520397902752,643.180056381527
2019,TX-624,"Wichita Falls/Wise, Palo Pinto, Wichita, Archer Counties CoC",243,11,232,634.2309523809524,603.2238095238095
2019,TX-700,"Houston, Pasadena, Conroe/Harris, Ft. Bend, Montgomery, Counties CoC",3938,661,3277,874.0,681.5769230769231
2019,TX-701,"Bryan, College Station/Brazos Valley CoC",123,16,107,602.7076923076924,669.5538461538462
2019,UT-500,Salt Lake City & County CoC,1844,383,1461,751.0,684.6666666666667
2019,UT-503,Utah Balance of State CoC,793,104,689,548.5979166666667,655.7819444444443
2019,UT-504,Provo/Mountainland CoC,161,25,136,789.1555555555556,631.4666666666667
2019,VA-500,"Richmond/Henrico, Chesterfield, Hanover Counties CoC",497,83,414,950.0,875.3489583333334
2019,VA-501,"Norfolk, Chesapeake, Suffolk/Isle of Wight, Southampton Counties CoC",700,77,623,917.1785714285714,823.0059523809524
2019,VA-502,"Roanoke City & County, Salem CoC",319,62,257,542.5833333333334,575.1944444444445
2019,VA-503,Virginia Beach CoC,260,38,222,987.0,970.0
2019,VA-504,Charlottesville CoC,165,35,130,877.3333333333334,702.4090909090909
2019,VA-505,"Newport News, Hampton/Virginia Peninsula CoC",427,53,374,987.0,895.2777777777778
2019,VA-508,Lynchburg CoC,78,5,73,614.0,649.7333333333333
2019,VA-513,"Harrisburg, Winchester/Western Virginia CoC",342,54,288,670.9603174603175,725.8571428571428
2019,VA-514,"Fredericksburg/Spotsylvania, Stafford Counties CoC",221,30,191,910.0,837.9
2019,VA-521,Virginia Balance of State CoC,761,24,737,602.7060116966368,676.3216141497393
2019,VA-603,Alexandria CoC,198,38,160,1540.0,1504.0
2019,VT-500,Vermont Balance of State CoC,780,116,664,834.1869047619048,750.654761904762
2019,VT-501,Burlington/Chittenden County CoC,309,74,235,1055.0,699.4
2019,WA-500,Seattle/King County CoC,11199,2213,8986,1513.0,963.8888888888888
2019,WA-501,Washington Balance of State CoC,5509,1414,4095,637.3576388888889,914.420138888889
2019,WA-502,Spokane City & County CoC,1309,257,1052,569.0,562.3333333333333
2019,WA-503,"Tacoma, Lakewood/Pierce County CoC",1486,364,1122,922.0,1066.125
2019,WA-504,Everett/Snohomish County CoC,1116,476,640,1513.0,1068.5
2019,WI-500,Wisconsin Balance of State CoC,2875,340,2535,594.6382233361181,650.286432748538
2019,WI-501,Milwaukee City & County CoC,885,73,812,659.0,606.25
2019,WI-502,Racine City & County CoC,200,15,185,593.0,628.25
2019,WI-503,Madison/Dane County CoC,578,105,473,824.0,597.5714285714286
2019,WV-500,"Wheeling, Weirton Area CoC",136,13,123,511.0,615.5
2019,WV-501,"Huntington/Cabell, Wayne Counties CoC",171,10,161,543.0,504.8958333333333
2019,WV-503,"Charleston/Kanawha, Putnam, Boone, Clay Counties CoC",293,50,243,585.8823529411765,517.8235294117646
2019,WV-508,West Virginia Balance of State CoC,797,88,709,572.7026441858795,551.3841431444373
2019,WY-500,Wyoming Statewide CoC,548,67,481,650.9172077922078,638.2488095238095
2018,AK-500,Anchorage CoC,1094,177,917,978.0,698.0
2018,AK-501,Alaska Balance of State CoC,922,180,742,777.0,944.0
2018,AL-500,"Birmingham/Jefferson, St. Clair, Shelby Counties CoC",901,119,782,749.0,609.9444444444445
2018,AL-501,Mobile City & County/Baldwin County CoC,551,59,492,754.1,627.125
2018,AL-502,Florence/Northwest Alabama CoC,256,136,120,515.0666666666666,506.33333333333337
2018,AL-503,Huntsville/North Alabama CoC,424,111,313,538.625,473.8541666666667
2018,AL-504,Montgomery City & County CoC,369,63,306,608.6875,510.8125
2018,AL-506,Tuscaloosa City & County CoC,57,4,53,640.0,634.0
2018,AL-507,Alabama Balance of State CoC,730,13,717,527.1909942182001,628.6306184012067
2018,AR-500,Little Rock/Central Arkansas CoC,1081,232,849,587.2333333333333,517.7333333333333
2018,AR-501,Fayetteville/Northwest Arkansas CoC,474,42,432,550.3666666666667,483.73333333333335
2018,AR-503,Arkansas  Balance of State  CoC,825,125,700,521.8274509803922,551.7908823529411
2018,AR-505,Southeast Arkansas CoC,101,0,101,501.0657142857143,524.9519047619048
2018,AZ-500,Arizona Balance of State CoC,2187,537,1650,601.02,609.7291666666667
2018,AZ-501,Tucson/Pima County CoC,1380,263,1117,579.0,648.8
2018,AZ-502,"Phoenix, Mesa/Maricopa County CoC",6298,974,5324,730.0,620.4
2018,CA-500,San Jose/Santa Clara City & County CoC,7254,2139,5115,1873.0,1200.6666666666667
2018,CA-501,San Francisco CoC,6857,1757,5100,2179.0,1809.5
2018,CA-502,"Oakland, Berkeley/Alameda County CoC",5496,1742,3754,1660.0,1445.8333333333333
2018,CA-503,Sacramento City & County CoC,3621,1192,2429,807.0,872.25
2018,CA-504,"Santa Rosa, Petaluma/Sonoma County CoC",2996,747,2249,1302.0,1168.3333333333333
2018,CA-505,Richmond/Contra Costa County CoC,2234,555,1679,1660.0,1300.7142857142858
2018,CA-506,"Salinas/Monterey, San Benito Counties CoC",3299,942,2357,1217.5,960.6666666666666
2018,CA-507,Marin County CoC,1095,399,696,2179.0,1403.0
2018,CA-508,Watsonville/Santa Cruz City & County CoC,2320,634,1686,1348.0,1588.8333333333333
2018,CA-509,Mendocino County CoC,880,96,784,753.0,747.4
2018,CA-510,"Turlock, Modesto/Stanislaus County CoC",1356,241,1115,769.0,1009.2
2018,CA-511,Stockton/San Joaquin County CoC,1685,262,1423,668.0,1047.8
2018,CA-512,Daly/San Mateo County CoC,1238,238,1000,2179.0,1628.25
2018,CA-513,"Visalia/Kings, Tulare Counties CoC",967,288,679,752.6,817.4
2018,CA-514,Fresno City & County/Madera County CoC,2144,524,1620,749.0666666666667,749.7
2018,CA-515,"Roseville, Rocklin/Placer County CoC",950,327,623,807.0,727.5833333333334
2018,CA-516,"Redding/Shasta, Siskiyou, Lassen, Plumas, Del Norte, Modoc, Sierra Counties CoC",1149,431,718,660.1481481481482,682.2407407407408
2018,CA-517,Napa City & County CoC,322,158,164,1095.0,897.0
2018,CA-518,Vallejo/Solano County CoC,1129,461,668,920.0,1258.1666666666667
2018,CA-519,"Chico, Paradise/Butte County CoC",1125,506,619,758.0,620.625
2018,CA-520,Merced City & County CoC,514,148,366,574.0,958.0
2018,CA-521,"Davis, Woodland/Yolo County CoC",448,157,291,917.0,772.3333333333334
2018,CA-522,Humboldt County CoC,703,363,340,683.0,695.0
2018,CA-523,"Colusa, Glenn, Trinity Counties CoC",268,94,174,602.125,716.0625
2018,CA-524,Yuba City & County/Sutter County CoC,765,172,593,716.0,766.5714285714286
2018,CA-525,El Dorado County CoC,645,211,434,807.0,696.6
2018,CA-526,"Amador, Calaveras, Mariposa, Tuolumne Counties CoC",398,72,326,711.3690476190477,685.8928571428571
2018,CA-600,Los Angeles City & County CoC,49955,13275,36680,1154.0,1004.25
2018,CA-601,San Diego City and County CoC,8576,2171,6405,1257.0,900.6666666666666
2018,CA-602,"Santa Ana, Anaheim/Orange County CoC",4955,1066,3889,1396.0,970.25
2018,CA-603,Santa Maria/Santa Barbara County CoC,1706,307,1399,1468.0,935.6666666666666
2018,CA-604,Bakersfield/Kern County CoC,885,133,752,719.0,960.1428571428571
2018,CA-608,Riverside City & County CoC,2316,474,1842,833.0,895.0
2018,CA-609,San Bernardino City & County CoC,2118,423,1695,833.0,837.0
2018,CA-611,"Oxnard, San Buenaventura/Ventura County CoC",1308,280,1028,1187.0,1006.6666666666666
2018,CA-613,Imperial County CoC,1493,44,1449,605.0,879.1666666666666
2018,CA-614,San Luis Obispo County CoC,1095,301,794,1031.0,906.75
2018,CO-500,Colorado Balance of State CoC,3989,797,3192,677.787668997669,581.3643434343436
2018,CO-503,Metropolitan Denver CoC,5317,1596,3721,1053.4743589743591,682.2051282051283
2018,CO-504,Colorado Springs/El Paso County CoC,1551,345,1206,705.0,756.2
2018,CT-503,"Bridgeport, Stamford, Norwalk, Danbury/Fairfield County CoC",864,83,781,1144.7826086956522,1149.4
2018,CT-505,Connecticut Balance of State CoC,3112,258,2854,826.4656084656084,915.9642598343686
2018,DE-500,Delaware Statewide CoC,1082,189,893,823.2261904761906,820.0714285714286
2018,FL-500,"Sarasota, Bradenton/Manatee, Sarasota Counties CoC",1192,250,942,821.0,661.1666666666666
2018,FL-501,Tampa/Hillsborough County CoC,1795,262,1533,817.0,713.0
2018,FL-502,"St. Petersburg, Clearwater, Largo/Pinellas County CoC",2612,434,2178,817.0,762.0
2018,FL-503,"Lakeland, Winterhaven/Polk County CoC",552,84,468,689.0,731.5277777777777
2018,FL-504,"Deltona, Daytona Beach/Volusia, Flagler Counties CoC",683,90,593,697.25,697.0
2018,FL-505,"Fort Walton Beach/Okaloosa, Walton Counties CoC",495,119,376,869.5,607.4166666666666
2018,FL-506,Tallahassee/Leon County CoC,909,151,758,620.25,563.8703703703704
2018,FL-507,"Orlando/Orange, Osceola, Seminole Counties CoC",2053,272,1781,898.0,647.1666666666666
2018,FL-508,"Gainesville/Alachua, Putnam Counties CoC",756,272,484,622.5,659.5416666666666
2018,FL-509,"Fort Pierce/St. Lucie, Indian River, Martin Counties CoC",1542,56,1486,722.35,715.85
2018,FL-510,"Jacksonville-Duval, Clay Counties CoC",1794,327,1467,647.0,603.6666666666666
2018,FL-511,"Pensacola/Escambia, Santa Rosa Counties CoC",632,78,554,750.0,738.0
2018,FL-512,St. Johns County CoC,342,65,277,647.0,724.0
2018,FL-513,"Palm Bay, Melbourne/Brevard County CoC",734,116,618,687.0,691.0
2018,FL-514,Ocala/Marion County CoC,572,124,448,640.0,642.2222222222222
2018,FL-515,"Panama City/Bay, Jackson Counties CoC",381,98,283,512.125,604.125
2018,FL-517,"Hendry, Hardee, Highlands Counties CoC",453,259,194,614.97,788.26
2018,FL-518,"Columbia, Hamilton, Lafayette, Suwannee Counties CoC",493,38,455,564.4499999999999,564.5333333333333
2018,FL-519,Pasco County CoC,2668,826,1842,817.0,716.75
2018,FL-520,"Citrus, Hernando, Lake, Sumter Counties CoC",711,36,675,763.4722222222223,690.8333333333334
2018,FL-600,Miami-Dade County CoC,3516,384,3132,933.0,971.3333333333334
2018,FL-601,Ft Lauderdale/Broward County CoC,2318,439,1879,946.0,814.75
2018,FL-602,Punta Gorda/Charlotte County CoC,164,45,119,682.0,710.5
2018,FL-603,"Ft Myers, Cape Coral/Lee County CoC",728,132,596,748.0,715.6666666666666
2018,FL-604,Monroe County CoC,973,62,911,1037.0,869.5
2018,FL-605,West Palm Beach/Palm Beach County CoC,1309,164,1145,912.0,783.2222222222222
2018,FL-606,Naples/Collier County CoC,653,119,534,829.0,867.6
2018,GA-500,Atlanta CoC,3076,335,2741,930.0,871.0
2018,GA-501,Georgia Balance of State CoC,3730,266,3464,688.4039600153787,646.6350249903884
2018,GA-503,Athens-Clarke County CoC,212,37,175,654.0,696.4
2018,GA-504,Augusta-Richmond County CoC,269,18,251,662.0,589.8333333333334
2018,GA-505,Columbus-Muscogee CoC,276,28,248,672.0,615.1666666666667
2018,GA-506,Marietta/Cobb County CoC,384,41,343,930.0,871.0
2018,GA-507,Savannah/Chatham County CoC,1009,223,786,914.0,759.3333333333333
2018,GA-508,DeKalb County CoC,321,46,275,930.0,871.0
2018,IA-500,"Sioux City/Dakota, Woodbury Counties CoC",264,27,237,541.0,450.66666666666663
2018,IA-501,Iowa Balance of State CoC,1721,133,1588,501.64898434898424,513.528626928627
2018,IA-502,Des Moines/Polk County CoC,764,110,654,638.0,559.8571428571429
2018,ID-500,Boise/Ada County CoC,756,182,574,580.0,531.4
2018,ID-501,Idaho Balance of State CoC,1256,142,1114,554.69375,552.0618055555556
2018,IL-500,McHenry County CoC,179,23,156,953.0,783.6
2018,IL-501,"Rockford/DeKalb, Winnebago, Boone Counties CoC",356,25,331,621.8,760.6
2018,IL-502,"Waukegan, North Chicago/Lake County CoC",277,33,244,953.0,744.4166666666666
2018,IL-503,"Champaign, Urbana, Rantoul/Champaign County CoC",188,9,179,657.0,512.0
2018,IL-506,"Joliet, Bolingbrook/Will County CoC",341,23,318,939.6428571428571,716.0
2018,IL-507,"Peoria, Pekin/Fulton, Tazewell, Peoria, Woodford Counties CoC",400,54,346,549.8888888888889,498.5555555555555
2018,IL-511,Cook County CoC,873,134,739,953.0,803.2857142857143
2018,IL-512,Bloomington/Central Illinois CoC,387,43,344,552.4431216931216,561.9113756613757
2018,IL-513,Springfield/Sangamon County CoC,271,32,239,588.0,485.4166666666667
2018,IL-514,DuPage County CoC,295,31,264,953.0,912.1666666666666
2018,IL-515,South Central Illinois CoC,92,5,87,521.3938271604937,519.9444444444445
2018,IL-516,Decatur/Macon County CoC,161,16,145,518.0,521.0000000000001
2018,IL-517,"Aurora, Elgin/Kane County CoC",430,145,285,953.0,858.8
2018,IL-518,"Rock Island, Moline/Northwestern Illinois CoC",198,0,198,514.2585034013606,563.2006802721088
2018,IL-519,West Central Illinois CoC,67,2,65,491.1700680272108,491.0897959183673
2018,IL-520,Southern Illinois CoC,282,31,251,485.00902777777776,502.43194444444447
2018,IN-502,Indiana Balance of State CoC,3576,244,3332,577.1086928104576,605.700112044818
2018,IN-503,Indianapolis CoC,1682,205,1477,638.0,630.0
2018,KS-502,Wichita/Sedgwick County CoC,573,33,540,545.0,479.8333333333333
2018,KS-503,Topeka/Shawnee County CoC,408,141,267,537.0,548.5
2018,KS-507,Kansas Balance of State CoC,918,82,836,541.4296536796536,522.1056443556444
2018,KY-500,Kentucky Balance of State CoC,2077,142,1935,515.7976757369614,511.8469387755102
2018,KY-501,Louisville-Jefferson County CoC,926,129,797,614.0,577.6
2018,KY-502,Lexington-Fayette County CoC,685,98,587,610.0,561.6666666666666
2018,LA-500,Lafayette/Acadiana CoC,363,64,299,546.1666666666667,511.2307692307692
2018,LA-502,"Shreveport, Bossier/Northwest Louisiana CoC",375,55,320,574.9444444444445,525.1666666666666
2018,LA-503,New Orleans/Jefferson Parish CoC,1188,193,995,755.0,726.4166666666667
2018,LA-505,Monroe/Northeast Louisiana CoC,187,10,177,555.2309523809524,528.25
2018,LA-506,Slidell/Southeast Louisiana CoC,194,25,169,691.8125,651.75
2018,LA-507,Alexandria/Central Louisiana CoC,177,28,149,565.9523809523808,491.93650793650795
2018,LA-509,Louisiana Balance of State CoC,575,101,474,664.160657051282,598.2540064102564
2018,MA-500,Boston CoC,6188,724,5464,1364.0,1157.9192473285611
2018,MA-503,Cape Cod Islands CoC,358,56,302,1079.25,942.8268518518519
2018,MA-504,Springfield/Hampden County CoC,3368,206,3162,780.0,760.4034722222223
2018,MA-506,Worcester City & County CoC,1852,133,1719,891.4333333333333,811.3970052178577
2018,MA-507,"Pittsfield/Berkshire, Franklin, Hampshire Counties CoC",651,72,579,880.9244791666666,774.7125
2018,MA-511,"Quincy, Brockton, Weymouth, Plymouth City and County CoC",1090,180,910,1200.148148148148,1073.9785714285715
2018,MA-516,Massachusetts Balance of State CoC,3945,366,3579,1307.3178604775244,927.6485695372792
2018,MA-519,"Attleboro, Taunton/Bristol County CoC",208,33,175,845.0,1040.5419973544972
2018,MD-501,Baltimore CoC,2508,592,1916,918.0,903.0
2018,MD-503,Annapolis/Anne Arundel County CoC,366,85,281,918.0,907.7777777777778
2018,MD-505,Baltimore County CoC,758,189,569,918.0,849.1666666666666
2018,MD-506,Carroll County CoC,173,31,142,918.0,723.6666666666666
2018,MD-511,Mid-Shore Regional CoC,141,19,122,847.3666666666666,825.7666666666667
2018,MD-513,"Wicomico, Somerset, Worcester Counties CoC",292,56,236,624.625,768.3333333333334
2018,MD-514,Maryland Balance of State CoC,1420,257,1163,822.4015151515152,694.405303030303
2018,ME-500,Maine Statewide CoC,2516,215,2301,744.9931034482759,818.7297297297298
2018,MI-500,Michigan Balance of State CoC,1413,57,1356,577.6615829346092,587.8645035885168
2018,MI-502,"Dearborn, Dearborn Heights, Westland/Wayne County CoC",211,16,195,644.0,666.5
2018,MI-503,"St. Clair Shores, Warren/Macomb County CoC",270,27,243,644.0,620.0
2018,MI-504,"Pontiac, Royal Oak/Oakland County CoC",427,42,385,644.0,648.3333333333334
2018,MI-505,Flint/Genesee County CoC,438,30,408,529.0,589.1666666666666
2018,MI-506,"Grand Rapids, Wyoming/Kent County CoC",723,102,621,621.0,551.6666666666666
2018,MI-507,"Portage, Kalamazoo City & County CoC",567,129,438,582.0,559.9166666666667
2018,MI-508,"Lansing, East Lansing/Ingham County CoC",419,43,376,620.0,585.0
2018,MI-509,Washtenaw County CoC,282,45,237,940.0,599.6666666666666
2018,MI-510,Saginaw City & County CoC,357,10,347,499.0,495.2
2018,MI-511,Lenawee County CoC,117,5,112,586.0,575.8333333333334
2018,MI-512,"Grand Traverse, Antrim, Leelanau Counties CoC",235,48,187,601.6458333333333,523.3854166666666
2018,MI-514,Battle Creek/Calhoun County CoC,236,25,211,498.0,544.6875
2018,MI-515,Monroe City & County CoC,209,24,185,684.0,644.25
2018,MI-516,"Norton Shores, Muskegon City & County CoC",159,19,140,585.0,576.7
2018,MI-517,Jackson City & County CoC,81,10,71,588.0,619.7142857142857
2018,MI-518,Livingston County CoC,90,0,90,682.0,609.6666666666666
2018,MI-519,Holland/Ottawa County CoC,226,4,222,597.0,591.0
2018,MI-523,Eaton County CoC,122,4,118,620.0,548.9166666666666
2018,MN-500,Minneapolis/Hennepin County CoC,3013,490,2523,760.0,743.0
2018,MN-501,Saint Paul/Ramsey County CoC,1424,235,1189,760.0,743.0
2018,MN-502,Rochester/Southeast Minnesota CoC,497,32,465,514.948717948718,547.6517094017094
2018,MN-503,"Dakota, Anoka, Washington, Scott, Carver Counties",625,78,547,760.0,653.5833333333334
2018,MN-504,Northeast Minnesota CoC,90,12,78,549.3942857142857,518.3142857142857
2018,MN-505,St. Cloud/Central Minnesota CoC,584,64,520,649.3163265306123,568.5833333333334
2018,MN-506,Northwest Minnesota CoC,274,22,252,500.20833333333337,515.25
2018,MN-508,Moorhead/West Central Minnesota CoC,246,25,221,472.08000000000004,488.4
2018,MN-509,Duluth/St.Louis County CoC,425,108,317,641.0,523.0
2018,MN-511,Southwest Minnesota CoC,65,0,65,495.3092592592593,536.3263532763533
2018,MO-500,St. Louis County CoC,450,45,405,651.0,650.0
2018,MO-501,St.Louis City CoC,949,95,854,651.0,650.0
2018,MO-503,"St. Charles City & County, Lincoln, Warren Counties CoC",532,33,499,651.0,606.1111111111112
2018,MO-600,"Springfield/Greene, Christian, Webster Counties CoC",479,135,344,598.0,465.1666666666667
2018,MO-602,"Joplin/Jasper, Newton Counties CoC",275,32,243,589.0,498.9444444444444
2018,MO-603,"St. Joseph/Andrew, Buchanan, DeKalb Counties CoC",204,62,142,560.0,530.0555555555555
2018,MO-606,Missouri Balance of State CoC,1345,250,1095,484.4441409897292,535.4015914208821
2018,MS-500,"Jackson/Rankin, Madison Counties CoC",446,172,274,661.5263157894738,479.70175438596493
2018,MS-501,Mississippi Balance of State CoC,560,58,502,529.7367698091383,565.9403315982264
2018,MS-503,Gulf Port/Gulf Coast Regional CoC,346,49,297,624.172619047619,696.0357142857142
2018,MT-500,Montana Statewide CoC,1405,200,1205,549.4272727272727,575.3075757575757
2018,NC-500,Winston-Salem/Forsyth County CoC,440,72,368,615.0,599.3333333333333
2018,NC-501,Asheville/Buncombe County CoC,554,82,472,712.0,571.0833333333333
2018,NC-502,Durham City & County CoC,338,68,270,780.0,705.3333333333334
2018,NC-503,North Carolina Balance of State CoC,2991,485,2506,628.8199413821474,625.2072274784039
2018,NC-504,"Greensboro, High Point CoC",657,36,621,667.0,623.2
2018,NC-505,Charlotte/Mecklenberg CoC,1668,217,1451,832.0,692.8888888888888
2018,NC-506,"Wilmington/Brunswick, New Hanover, Pender Counties CoC",333,32,301,760.4166666666667,650.0833333333333
2018,NC-507,Raleigh/Wake County CoC,983,121,862,791.0,716.25
2018,NC-509,"Gastonia/Cleveland, Gaston, Lincoln Counties CoC",331,79,252,676.9,640.4666666666667
2018,NC-511,Fayetteville/Cumberland County CoC,372,67,305,724.0,534.5
2018,NC-513,Chapel Hill/Orange County CoC,152,19,133,780.0,685.75
2018,NC-516,Northwest North Carolina CoC,449,15,434,560.1153846153846,579.2939560439561
2018,ND-500,North Dakota Statewide CoC,542,76,466,590.0307765151515,461.49147727272725
2018,NE-500,Nebraska Balance of State CoC,559,24,535,487.8824175824176,529.5708333333333
2018,NE-501,"Omaha, Council Bluffs CoC",1411,358,1053,645.0,547.1666666666667
2018,NE-502,Lincoln CoC,451,73,378,607.0,483.5
2018,NH-500,New Hampshire Balance of State CoC,742,135,607,842.7746621621621,810.2109208125222
2018,NH-502,Nashua/Hillsborough County CoC,281,10,271,779.6129032258065,929.4996241339378
2018,NJ-500,Atlantic City & County CoC,437,105,332,951.0,895.5833333333334
2018,NJ-501,Bergen County CoC,354,11,343,1246.0,1289.8333333333333
2018,NJ-502,Burlington County CoC,840,81,759,883.0,935.0
2018,NJ-503,"Camden City & County/Gloucester, Cape May, Cumberland Counties CoC",999,146,853,862.0833333333334,864.3333333333334
2018,NJ-504,Newark/Essex County CoC,2228,250,1978,1059.0,1152.0
2018,NJ-506,"Jersey City, Bayonne/Hudson County CoC",860,226,634,1301.0,1203.75
2018,NJ-507,New Brunswick/Middlesex County CoC,597,88,509,1107.0,1139.8
2018,NJ-508,Monmouth County CoC,335,40,295,993.0,1092.6
2018,NJ-509,Morris County CoC,398,65,333,1059.0,1095.6
2018,NJ-510,Lakewood Township/Ocean County CoC,354,52,302,993.0,944.6666666666666
2018,NJ-511,Paterson/Passaic County CoC,434,95,339,1246.0,1134.0
2018,NJ-513,Somerset County CoC,218,5,213,1107.0,1083.4
2018,NJ-514,Trenton/Mercer County CoC,479,46,433,962.0,1011.0
2018,NJ-515,Elizabeth/Union County CoC,478,43,435,1059.0,1187.1666666666667
2018,NJ-516,"Warren, Sussex, Hunterdon Counties CoC",338,30,308,1054.4285714285713,993.6785714285714
2018,NM-501,New Mexico Balance of State CoC,1211,470,741,592.9756493506494,530.9077380952381
2018,NV-500,Las Vegas/Clark County CoC,6083,505,5578,683.0,639.75
2018,NV-501,"Reno, Sparks/Washoe County CoC",1192,106,1086,668.0,669.2666666666667
2018,NV-502,Nevada Balance of State CoC,269,37,232,588.4876543209876,630.8223104056437
2018,NY-500,"Rochester, Irondequoit, Greece/Monroe County CoC",835,90,745,672.0,646.1666666666666
2018,NY-501,"Elmira/Steuben, Allegany, Livingston, Chemung, Schuyler Counties CoC",233,0,233,608.9083333333333,605.55
2018,NY-503,Albany City & County CoC,835,99,736,747.0,730.6
2018,NY-505,"Syracuse, Auburn/Onondaga, Oswego, Cayuga Counties CoC",722,36,686,608.4666666666667,702.0
2018,NY-507,Schenectady City & County CoC,393,38,355,747.0,718.1666666666666
2018,NY-508,"Buffalo, Niagara Falls/Erie, Niagara, Orleans, Genesee, Wyoming Counties CoC",957,25,932,602.375,599.75
2018,NY-510,Ithaca/Tompkins County CoC,91,5,86,1013.0,586.25
2018,NY-511,"Binghamton, Union Town/Broome, Otsego, Chenango, Delaware, Cortland, Tioga Count",244,21,223,621.0375,687.9187499999999
2018,NY-512,Troy/Rensselaer County CoC,178,7,171,747.0,744.7375
2018,NY-513,"Wayne, Ontario, Seneca, Yates Counties CoC",182,6,176,653.25,682.9
2018,NY-514,"Jamestown, Dunkirk/Chautauqua County CoC",145,1,144,569.0,603.25
2018,NY-518,"Utica, Rome/Oneida, Madison Counties CoC",178,19,159,629.7708333333334,645.1875
2018,NY-519,"Columbia, Greene Counties CoC",196,4,192,686.5,751.5267857142857
2018,NY-520,"Franklin, Essex Counties CoC",42,0,42,591.55,746.7
2018,NY-522,"Jefferson, Lewis, St. Lawrence Counties CoC",96,2,94,646.6333333333333,650.4666666666667
2018,NY-523,"Glens Falls, Saratoga Springs/Saratoga, Washington, Warren, Hamilton Counties Co",257,16,241,695.2857142857143,702.3095238095239
2018,NY-600,New York City CoC,78676,6336,72340,1649.0,1178.7142857142858
2018,NY-601,Poughkeepsie/Dutchess County CoC,399,26,373,970.0,928.7690217391304
2018,NY-602,"Newburgh, Middletown/Orange County CoC",480,101,379,970.0,1045.2857142857142
2018,NY-603,"Nassau, Suffolk Counties CoC",3868,117,3751,1317.0,1104.80071773637
2018,NY-604,"Yonkers, Mount Vernon/Westchester County CoC",1827,164,1663,1459.0,1335.4492753623188
2018,NY-606,Rockland County CoC,180,37,143,1649.0,1205.4
2018,NY-608,Kingston/Ulster County CoC,464,32,432,783.0,782.0
2018,OH-500,Cincinnati/Hamilton County CoC,1114,70,1044,598.0,552.8333333333334
2018,OH-501,Toledo/Lucas County CoC,662,51,611,494.0,558.8333333333334
2018,OH-502,Cleveland/Cuyahoga County CoC,1808,172,1636,567.0,557.4
2018,OH-503,Columbus/Franklin County CoC,1807,137,1670,641.0,614.3333333333334
2018,OH-504,Youngstown/Mahoning County CoC,180,25,155,509.0,518.5
2018,OH-505,"Dayton, Kettering/Montgomery County CoC",680,30,650,550.0,542.5714285714286
2018,OH-506,"Akron, Barberton/Summit County CoC",587,46,541,575.0,545.9166666666666
2018,OH-507,Ohio Balance of State CoC,3133,196,2937,532.8091166096068,553.5528503994191
2018,OH-508,"Canton, Massillon, Alliance/Stark County CoC",278,3,275,500.0,521.1111111111112
2018,OK-500,North Central Oklahoma CoC,181,7,174,565.9666666666667,501.5666666666666
2018,OK-501,Tulsa City & County CoC,1083,159,924,588.0,510.5555555555556
2018,OK-502,Oklahoma City CoC,1183,260,923,653.0,566.3333333333333
2018,OK-503,Oklahoma Balance of State CoC,233,42,191,535.2721984805318,537.3473409306742
2018,OK-504,Norman/Cleveland County CoC,364,303,61,653.0,605.0
2018,OK-505,Northeast Oklahoma CoC,392,93,299,541.6326530612245,533.1428571428571
2018,OK-506,Southwest Oklahoma Regional CoC,191,0,191,520.5854166666667,549.4979166666667
2018,OK-507,Southeastern Oklahoma Regional CoC,244,44,200,501.5791666666667,542.9395833333333
2018,OR-500,"Eugene, Springfield/Lane County CoC",1641,712,929,659.0,638.9
2018,OR-501,"Portland, Gresham/Multnomah County CoC",4019,1384,2635,1117.0,956.5
2018,OR-502,"Medford, Ashland/Jackson County CoC",732,259,473,661.0,553.0
2018,OR-503,Central Oregon CoC,787,172,615,639.4,550.9666666666667
2018,OR-505,Oregon Balance of State CoC,6392,1503,4889,651.1880787037036,697.8552083333334
2018,OR-506,"Hillsboro, Beaverton/Washington County CoC",522,166,356,1117.0,958.0
2018,OR-507,Clackamas County CoC,383,125,258,1117.0,839.6666666666666
2018,PA-500,Philadelphia CoC,5788,943,4845,883.0,845.0
2018,PA-501,Harrisburg/Dauphin County CoC,445,47,398,720.0,631.0
2018,PA-502,"Upper Darby, Chester, Haverford/Delaware County CoC",414,33,381,883.0,845.0
2018,PA-503,"Wilkes-Barre, Hazleton/Luzerne County CoC",165,0,165,621.0,622.5
2018,PA-504,"Lower Merion, Norristown, Abington/Montgomery County CoC",291,20,271,883.0,787.8333333333334
2018,PA-505,Chester County CoC,579,11,568,883.0,783.6666666666666
2018,PA-506,Reading/Berks County CoC,562,5,557,619.0,755.5833333333334
2018,PA-508,Scranton/Lackawanna County CoC,159,12,147,621.0,627.875
2018,PA-509,Eastern Pennsylvania CoC,1998,91,1907,684.1218749999999,707.3281249999999
2018,PA-510,Lancaster City & County CoC,406,22,384,707.0,713.1666666666666
2018,PA-511,"Bristol, Bensalem/Bucks County CoC",397,25,372,883.0,871.0833333333334
2018,PA-512,York City & County CoC,324,13,311,655.0,780.6666666666666
2018,PA-600,"Pittsburgh, McKeesport, Penn Hills/Allegheny County CoC",783,117,666,667.0,609.0
2018,PA-601,Western Pennsylvania CoC,748,46,702,593.2291666666666,569.5833333333334
2018,PA-603,Beaver County CoC,117,3,114,667.0,546.5833333333334
2018,PA-605,Erie City & County CoC,336,20,316,619.0,546.1666666666666
2018,PR-502,Puerto Rico Balance of Commonwealth CoC,1643,662,981,391.97058823529414,413.9117647058824
2018,PR-503,South-Southeast Puerto Rico CoC,1539,429,1110,401.47058823529414,403.2352941176471
2018,RI-500,Rhode Island Statewide CoC,1101,264,837,812.0000000000001,985.532380952381
2018,SC-500,Charleston/Low Country CoC,451,86,365,677.9047619047619,622.7916666666666
2018,SC-501,"Greenville, Anderson, Spartanburg/Upstate CoC",1185,181,1004,572.6555555555556,566.7922222222222
2018,SC-502,Columbia/Midlands CoC,1205,248,957,564.4027777777777,626.470804988662
2018,SC-503,"Myrtle Beach, Sumter City & County CoC",1092,171,921,623.9602272727273,681.2670454545455
2018,SD-500,South Dakota Statewide CoC,1159,190,969,487.2488226059655,487.5913134484563
2018,TN-500,Chattanooga/Southeast Tennessee CoC,623,322,301,500.1706349206349,511.9761904761905
2018,TN-501,Memphis/Shelby County CoC,1226,87,1139,670.0,620.0
2018,TN-502,Knoxville/Knox County CoC,743,177,566,586.0,511.42857142857144
2018,TN-503,Central Tennessee CoC,268,46,222,593.078869047619,579.0875
2018,TN-504,Nashville-Davidson County CoC,2298,637,1661,777.0,740.0
2018,TN-506,Upper Cumberland CoC,258,9,249,590.5319727891157,598.3609977324262
2018,TN-507,Jackson/West Tennessee CoC,1026,72,954,532.5559523809524,528.6559523809523
2018,TN-509,Appalachian Regional CoC,360,51,309,479.0178571428571,563.2142857142858
2018,TN-510,Murfreesboro/Rutherford County CoC,283,100,183,777.0,683.6666666666666
2018,TN-512,"Morristown/Blount, Sevier, Campbell, Cocke Counties CoC",798,162,636,504.0843537414966,503.09880952380956
2018,TX-500,San Antonio/Bexar County CoC,3066,479,2587,691.0,636.1428571428571
2018,TX-503,Austin/Travis County CoC,2147,498,1649,928.0,812.0
2018,TX-600,"Dallas City & County, Irving CoC",4121,587,3534,789.0,704.8888888888889
2018,TX-601,"Fort Worth, Arlington/Tarrant County CoC",2015,278,1737,784.0,711.7166666666667
2018,TX-603,El Paso City & County CoC,892,151,741,578.0,555.25
2018,TX-604,Waco/McLennan County CoC,188,22,166,529.6333333333334,614.9333333333334
2018,TX-607,Texas Balance of State CoC,7638,644,6994,626.5544063779357,616.9703727644904
2018,TX-624,"Wichita Falls/Wise, Palo Pinto, Wichita, Archer Counties CoC",238,19,219,622.4964285714286,569.9857142857143
2018,TX-700,"Houston, Pasadena, Conroe/Harris, Ft. Bend, Montgomery, Counties CoC",4143,669,3474,830.0,663.3846153846154
2018,TX-701,"Bryan, College Station/Brazos Valley CoC",197,10,187,595.5641025641025,650.9897435897436
2018,UT-500,Salt Lake City & County CoC,1804,227,1577,705.0,642.8333333333334
2018,UT-503,Utah Balance of State CoC,899,56,843,541.2743055555555,617.9076388888889
2018,UT-504,Provo/Mountainland CoC,173,23,150,796.1333333333333,596.6999999999999
2018,VA-500,"Richmond/Henrico, Chesterfield, Hanover Counties CoC",609,90,519,924.0,844.0
2018,VA-501,"Norfolk, Chesapeake, Suffolk/Isle of Wight, Southampton Counties CoC",773,90,683,895.7976190476192,793.3869047619048
2018,VA-502,"Roanoke City & County, Salem CoC",317,36,281,569.5277777777778,575.4652777777778
2018,VA-503,Virginia Beach CoC,243,40,203,970.0,934.0
2018,VA-504,Charlottesville CoC,183,41,142,797.7424242424242,680.030303030303
2018,VA-505,"Newport News, Hampton/Virginia Peninsula CoC",439,63,376,970.0,868.0555555555555
2018,VA-508,Lynchburg CoC,112,8,104,608.0,631.9166666666666
2018,VA-513,"Harrisburg, Winchester/Western Virginia CoC",304,42,262,677.2857142857143,716.8214285714286
2018,VA-514,"Fredericksburg/Spotsylvania, Stafford Counties CoC",200,36,164,905.0,809.5
2018,VA-521,Virginia Balance of State CoC,718,38,680,621.2857233911922,656.6155479936731
2018,VA-603,Alexandria CoC,226,60,166,1504.0,1440.0
2018,VT-500,Vermont Balance of State CoC,932,118,814,852.552380952381,712.6160714285714
2018,VT-501,Burlington/Chittenden County CoC,359,42,317,971.0,682.0
2018,WA-500,Seattle/King County CoC,12112,3552,8560,1456.0,842.4444444444445
2018,WA-501,Washington Balance of State CoC,5666,1493,4173,605.9236111111111,801.2152777777777
2018,WA-502,Spokane City & County CoC,1245,265,980,553.0,547.375
2018,WA-503,"Tacoma, Lakewood/Pierce County CoC",1628,366,1262,821.0,914.75
2018,WA-504,Everett/Snohomish County CoC,858,367,491,1456.0,909.25
2018,WI-500,Wisconsin Balance of State CoC,3147,285,2862,577.2721498189919,620.6385185185185
2018,WI-501,Milwaukee City & County CoC,871,96,775,650.0,571.25
2018,WI-502,Racine City & County CoC,275,22,253,593.0,599.3333333333334
2018,WI-503,Madison/Dane County CoC,614,124,490,815.0,562.4285714285714
2018,WV-500,"Wheeling, Weirton Area CoC",108,21,87,517.9333333333334,601.4166666666667
2018,WV-501,"Huntington/Cabell, Wayne Counties CoC",190,6,184,504.0,537.3125
2018,WV-503,"Charleston/Kanawha, Putnam, Boone, Clay Counties CoC",317,31,286,548.6470588235294,517.7058823529412
2018,WV-508,West Virginia Balance of State CoC,628,96,532,558.6675966027436,547.6240788623141
2018,WY-500,Wyoming Statewide CoC,639,46,593,631.5209956709957,588.0808441558441
2017,AK-500,Anchorage CoC,1128,116,1012,944.0,655.0
2017,AK-501,Alaska Balance of State CoC,717,141,576,698.0,940.0
2017,AL-500,"Birmingham/Jefferson, St. Clair, Shelby Counties CoC",1092,92,1000,719.0,584.8888888888889
2017,AL-501,Mobile City & County/Baldwin County CoC,606,65,541,817.15,576.4
2017,AL-502,Florence/Northwest Alabama CoC,155,24,131,516.0666666666666,474.8
2017,AL-503,Huntsville/North Alabama CoC,436,64,372,553.3333333333334,463.2708333333333
2017,AL-504,Montgomery City & County CoC,377,45,332,612.75,458.5
2017,AL-506,Tuscaloosa City & County CoC,200,24,176,602.0,592.9166666666667
2017,AL-507,Alabama Balance of State CoC,764,6,758,526.9027463549522,596.1990384615384
2017,AR-500,Little Rock/Central Arkansas CoC,1006,226,780,579.6,496.8833333333333
2017,AR-501,Fayetteville/Northwest Arkansas CoC,330,66,264,580.8000000000001,478.9666666666667
2017,AR-503,Arkansas  Balance of State  CoC,875,110,765,506.22941176470584,528.506568627451
2017,AR-505,Southeast Arkansas CoC,88,0,88,493.8585714285714,498.5190476190476
2017,AZ-500,Arizona Balance of State CoC,1768,388,1380,578.1775,596.125
2017,AZ-501,Tucson/Pima County CoC,1574,225,1349,585.0,620.5
2017,AZ-502,"Phoenix, Mesa/Maricopa County CoC",5605,939,4666,666.0,604.5
2017,CA-500,San Jose/Santa Clara City & County CoC,7394,2097,5297,1641.0,1052.8333333333333
2017,CA-501,San Francisco CoC,6858,2138,4720,2072.0,1523.0
2017,CA-502,"Oakland, Berkeley/Alameda County CoC",5629,1707,3922,1547.0,1233.1666666666667
2017,CA-503,Sacramento City & County CoC,3665,1126,2539,768.0,851.0
2017,CA-504,"Santa Rosa, Petaluma/Sonoma County CoC",2835,598,2237,1120.0,1074.6666666666667
2017,CA-505,Richmond/Contra Costa County CoC,1607,331,1276,1547.0,1127.7142857142858
2017,CA-506,"Salinas/Monterey, San Benito Counties CoC",3364,902,2462,1053.5,891.8333333333334
2017,CA-507,Marin County CoC,1117,359,758,2072.0,1232.25
2017,CA-508,Watsonville/Santa Cruz City & County CoC,2249,600,1649,1253.0,1346.1666666666667
2017,CA-509,Mendocino County CoC,1238,97,1141,763.0,734.6
2017,CA-510,"Turlock, Modesto/Stanislaus County CoC",1661,178,1483,690.0,977.2
2017,CA-511,Stockton/San Joaquin County CoC,1542,254,1288,653.0,1017.4
2017,CA-512,Daly/San Mateo County CoC,1253,234,1019,2072.0,1395.25
2017,CA-513,"Visalia/Kings, Tulare Counties CoC",853,251,602,677.8,814.8
2017,CA-514,Fresno City & County/Madera County CoC,2016,692,1324,715.5333333333333,762.7333333333333
2017,CA-515,"Roseville, Rocklin/Placer County CoC",979,232,747,768.0,707.75
2017,CA-516,"Redding/Shasta, Siskiyou, Lassen, Plumas, Del Norte, Modoc, Sierra Counties CoC",934,341,593,663.4444444444445,660.5925925925926
2017,CA-517,Napa City & County CoC,315,134,181,1101.0,889.5
2017,CA-518,Vallejo/Solano County CoC,1232,434,798,873.0,1120.8333333333333
2017,CA-519,"Chico, Paradise/Butte County CoC",1195,531,664,697.0,608.125
2017,CA-520,Merced City & County CoC,454,120,334,554.0,912.1
2017,CA-521,"Davis, Woodland/Yolo County CoC",459,174,285,941.0,766.1666666666666
2017,CA-522,Humboldt County CoC,759,310,449,736.0,721.3333333333334
2017,CA-523,"Colusa, Glenn, Trinity Counties CoC",176,34,142,592.875,709.875
2017,CA-524,Yuba City & County/Sutter County CoC,760,150,610,697.0,755.0714285714286
2017,CA-525,El Dorado County CoC,602,241,361,768.0,687.6
2017,CA-526,"Amador, Calaveras, Mariposa, Tuolumne Counties CoC",367,71,296,683.0714285714286,689.9642857142857
2017,CA-600,Los Angeles City & County CoC,52442,16249,36193,1069.0,937.25
2017,CA-601,San Diego City and County CoC,9160,2176,6984,1212.0,863.0
2017,CA-602,"Santa Ana, Anaheim/Orange County CoC",4792,893,3899,1352.0,939.0
2017,CA-603,Santa Maria/Santa Barbara County CoC,1860,226,1634,1285.0,874.3333333333334
2017,CA-604,Bakersfield/Kern County CoC,810,289,521,666.0,917.7857142857143
2017,CA-608,Riverside City & County CoC,2406,418,1988,800.0,855.6
2017,CA-609,San Bernardino City & County CoC,1866,441,1425,800.0,814.8571428571429
2017,CA-611,"Oxnard, San Buenaventura/Ventura County CoC",1152,385,767,1199.0,958.3333333333334
2017,CA-613,Imperial County CoC,1154,105,1049,550.0,843.8333333333334
2017,CA-614,San Luis Obispo County CoC,1125,282,843,942.0,880.75
2017,CO-500,Colorado Balance of State CoC,4019,807,3212,612.5415384615384,568.4094172494172
2017,CO-503,Metropolitan Denver CoC,5506,1083,4423,872.3333333333334,623.5512820512821
2017,CO-504,Colorado Springs/El Paso County CoC,1415,374,1041,652.0,713.0
2017,CT-503,"Bridgeport, Stamford, Norwalk, Danbury/Fairfield County CoC",778,52,726,1079.695652173913,1052.0
2017,CT-505,Connecticut Balance of State CoC,2610,368,2242,753.6698412698413,852.8287525879917
2017,DE-500,Delaware Statewide CoC,994,127,867,818.9523809523808,777.9880952380952
2017,FL-500,"Sarasota, Bradenton/Manatee, Sarasota Counties CoC",1447,285,1162,823.0,663.75
2017,FL-501,Tampa/Hillsborough County CoC,1549,235,1314,762.0,694.4
2017,FL-502,"St. Petersburg, Clearwater, Largo/Pinellas County CoC",2831,690,2141,762.0,712.0
2017,FL-503,"Lakeland, Winterhaven/Polk County CoC",512,77,435,675.0,700.638888888889
2017,FL-504,"Deltona, Daytona Beach/Volusia, Flagler Counties CoC",753,88,665,705.75,655.1666666666666
2017,FL-505,"Fort Walton Beach/Okaloosa, Walton Counties CoC",401,112,289,797.5,572.0
2017,FL-506,Tallahassee/Leon County CoC,1072,117,955,591.6111111111112,544.3703703703703
2017,FL-507,"Orlando/Orange, Osceola, Seminole Counties CoC",2074,194,1880,809.0,644.5833333333334
2017,FL-508,"Gainesville/Alachua, Putnam Counties CoC",819,291,528,613.6944444444445,624.6666666666666
2017,FL-509,"Fort Pierce/St. Lucie, Indian River, Martin Counties CoC",1732,57,1675,726.9,680.1
2017,FL-510,"Jacksonville-Duval, Clay Counties CoC",1869,319,1550,662.0,588.0
2017,FL-511,"Pensacola/Escambia, Santa Rosa Counties CoC",758,135,623,792.0,653.6666666666666
2017,FL-512,St. Johns County CoC,445,42,403,662.0,596.3333333333334
2017,FL-513,"Palm Bay, Melbourne/Brevard County CoC",845,167,678,594.0,667.0
2017,FL-514,Ocala/Marion County CoC,725,147,578,683.0,614.6666666666666
2017,FL-515,"Panama City/Bay, Jackson Counties CoC",336,38,298,537.2083333333334,592.2083333333334
2017,FL-517,"Hendry, Hardee, Highlands Counties CoC",609,283,326,586.8900000000001,743.42
2017,FL-518,"Columbia, Hamilton, Lafayette, Suwannee Counties CoC",502,38,464,559.5500000000001,605.1666666666666
2017,FL-519,Pasco County CoC,2593,847,1746,762.0,697.5
2017,FL-520,"Citrus, Hernando, Lake, Sumter Counties CoC",635,40,595,706.4166666666666,665.0
2017,FL-600,Miami-Dade County CoC,3721,309,3412,890.0,894.6666666666666
2017,FL-601,Ft Lauderdale/Broward County CoC,2450,581,1869,882.0,753.0
2017,FL-602,Punta Gorda/Charlotte County CoC,222,33,189,670.0,693.0
2017,FL-603,"Ft Myers, Cape Coral/Lee County CoC",431,65,366,732.0,678.5
2017,FL-604,Monroe County CoC,631,83,548,1183.0,797.0
2017,FL-605,West Palm Beach/Palm Beach County CoC,1607,252,1355,869.0,724.8888888888888
2017,FL-606,Naples/Collier County CoC,621,90,531,849.0,825.8
2017,GA-500,Atlanta CoC,3572,346,3226,871.0,813.0
2017,GA-501,Georgia Balance of State CoC,3716,242,3474,637.2524990388312,614.7910226835833
2017,GA-503,Athens-Clarke County CoC,239,53,186,665.0,663.4
2017,GA-504,Augusta-Richmond County CoC,246,30,216,603.0,562.4166666666666
2017,GA-505,Columbus-Muscogee CoC,319,21,298,655.0,599.6666666666667
2017,GA-506,Marietta/Cobb County CoC,403,53,350,871.0,813.0
2017,GA-507,Savannah/Chatham County CoC,926,234,692,755.0,680.1666666666667
2017,GA-508,DeKalb County CoC,460,47,413,871.0,813.0
2017,IA-500,"Sioux City/Dakota, Woodbury Counties CoC",288,17,271,507.0,433.2
2017,IA-501,Iowa Balance of State CoC,1792,107,1685,484.2880674880676,486.6927294927294
2017,IA-502,Des Moines/Polk County CoC,676,75,601,601.0,541.8571428571429
2017,ID-500,Boise/Ada County CoC,833,327,506,539.0,494.2
2017,ID-501,Idaho Balance of State CoC,1204,109,1095,534.1895833333333,554.723611111111
2017,IL-500,McHenry County CoC,155,5,150,912.0,751.5
2017,IL-501,"Rockford/DeKalb, Winnebago, Boone Counties CoC",381,31,350,606.2,696.6666666666667
2017,IL-502,"Waukegan, North Chicago/Lake County CoC",228,18,210,912.0,716.3333333333334
2017,IL-503,"Champaign, Urbana, Rantoul/Champaign County CoC",160,11,149,582.0,497.25
2017,IL-506,"Joliet, Bolingbrook/Will County CoC",282,24,258,895.2619047619048,678.4761904761905
2017,IL-507,"Peoria, Pekin/Fulton, Tazewell, Peoria, Woodford Counties CoC",329,73,256,523.6666666666666,471.3888888888889
2017,IL-511,Cook County CoC,780,107,673,912.0,761.4285714285714
2017,IL-512,Bloomington/Central Illinois CoC,433,52,381,519.7883597883598,538.4484126984128
2017,IL-513,Springfield/Sangamon County CoC,230,29,201,562.0,469.7916666666667
2017,IL-514,DuPage County CoC,331,36,295,912.0,839.8333333333334
2017,IL-515,South Central Illinois CoC,108,5,103,508.98827160493823,493.49629629629635
2017,IL-516,Decatur/Macon County CoC,130,23,107,468.0,493.8888888888889
2017,IL-517,"Aurora, Elgin/Kane County CoC",360,63,297,912.0,789.4
2017,IL-518,"Rock Island, Moline/Northwestern Illinois CoC",243,0,243,487.75850340136054,523.4795918367347
2017,IL-519,West Central Illinois CoC,80,1,79,477.374149659864,467.43809523809523
2017,IL-520,Southern Illinois CoC,435,85,350,476.225,481.7416666666667
2017,IN-502,Indiana Balance of State CoC,3655,330,3325,553.892035480859,574.6491596638655
2017,IN-503,Indianapolis CoC,1783,207,1576,630.0,589.0
2017,KS-502,Wichita/Sedgwick County CoC,575,39,536,513.0,462.0
2017,KS-503,Topeka/Shawnee County CoC,356,119,237,511.0,531.1666666666666
2017,KS-507,Kansas Balance of State CoC,1037,135,902,530.4874708624709,497.4575424575424
2017,KY-500,Kentucky Balance of State CoC,1940,164,1776,501.86927437641725,493.3806122448979
2017,KY-501,Louisville-Jefferson County CoC,1034,123,911,587.0,565.4
2017,KY-502,Lexington-Fayette County CoC,1051,118,933,567.0,562.3333333333334
2017,LA-500,Lafayette/Acadiana CoC,357,49,308,484.474358974359,482.448717948718
2017,LA-502,"Shreveport, Bossier/Northwest Louisiana CoC",349,31,318,559.4444444444445,499.84722222222223
2017,LA-503,New Orleans/Jefferson Parish CoC,1301,404,897,728.0,708.1666666666667
2017,LA-505,Monroe/Northeast Louisiana CoC,185,13,172,500.6690476190476,503.85
2017,LA-506,Slidell/Southeast Louisiana CoC,248,26,222,651.625,611.9166666666666
2017,LA-507,Alexandria/Central Louisiana CoC,159,20,139,513.5039682539683,472.9464285714286
2017,LA-509,Louisiana Balance of State CoC,706,75,631,617.099358974359,584.9615384615385
2017,MA-500,Boston CoC,6135,769,5366,1300.0,1053.9213741051976
2017,MA-503,Cape Cod Islands CoC,324,47,277,958.25,880.2583333333333
2017,MA-504,Springfield/Hampden County CoC,2311,132,2179,743.0,713.7756944444445
2017,MA-506,Worcester City & County CoC,1507,89,1418,782.3666666666667,756.914188793797
2017,MA-507,"Pittsfield/Berkshire, Franklin, Hampshire Counties CoC",557,79,478,754.45703125,745.6229166666667
2017,MA-511,"Quincy, Brockton, Weymouth, Plymouth City and County CoC",1109,143,966,1081.7037037037037,1023.8821428571429
2017,MA-516,Massachusetts Balance of State CoC,3627,358,3269,1249.5348565352067,857.2896790800016
2017,MA-519,"Attleboro, Taunton/Bristol County CoC",234,22,212,803.95,972.0863095238094
2017,MD-501,Baltimore CoC,2669,699,1970,903.0,851.0
2017,MD-503,Annapolis/Anne Arundel County CoC,376,91,285,903.0,823.8888888888888
2017,MD-505,Baltimore County CoC,609,144,465,903.0,789.8333333333334
2017,MD-506,Carroll County CoC,147,20,127,903.0,724.3333333333334
2017,MD-511,Mid-Shore Regional CoC,153,24,129,865.2,781.6333333333334
2017,MD-513,"Wicomico, Somerset, Worcester Counties CoC",260,41,219,611.7916666666666,751.0833333333334
2017,MD-514,Maryland Balance of State CoC,1446,280,1166,799.7575757575756,658.3787878787879
2017,ME-500,Maine Statewide CoC,2280,201,2079,677.6896551724138,749.6324324324324
2017,MI-500,Michigan Balance of State CoC,1549,59,1490,554.3464015151515,569.1159988038278
2017,MI-502,"Dearborn, Dearborn Heights, Westland/Wayne County CoC",226,8,218,620.0,633.5
2017,MI-503,"St. Clair Shores, Warren/Macomb County CoC",354,31,323,620.0,572.0
2017,MI-504,"Pontiac, Royal Oak/Oakland County CoC",412,45,367,620.0,603.0
2017,MI-505,Flint/Genesee County CoC,420,42,378,495.0,527.0
2017,MI-506,"Grand Rapids, Wyoming/Kent County CoC",912,108,804,583.0,544.4666666666667
2017,MI-507,"Portage, Kalamazoo City & County CoC",479,26,453,548.0,511.5833333333333
2017,MI-508,"Lansing, East Lansing/Ingham County CoC",435,45,390,566.0,548.625
2017,MI-509,Washtenaw County CoC,302,43,259,860.0,557.8333333333334
2017,MI-510,Saginaw City & County CoC,388,22,366,509.0,474.8
2017,MI-511,Lenawee County CoC,128,15,113,602.0,547.0
2017,MI-512,"Grand Traverse, Antrim, Leelanau Counties CoC",228,37,191,570.2604166666667,516.0416666666667
2017,MI-514,Battle Creek/Calhoun County CoC,204,22,182,545.0,530.0625
2017,MI-515,Monroe City & County CoC,193,13,180,566.0,608.75
2017,MI-516,"Norton Shores, Muskegon City & County CoC",135,2,133,543.0,557.8
2017,MI-517,Jackson City & County CoC,140,2,138,515.0,586.7142857142857
2017,MI-518,Livingston County CoC,103,1,102,675.0,572.1666666666666
2017,MI-519,Holland/Ottawa County CoC,258,4,254,550.0,602.2
2017,MI-523,Eaton County CoC,107,0,107,566.0,523.8333333333334
2017,MN-500,Minneapolis/Hennepin County CoC,3057,342,2715,743.0,698.0
2017,MN-501,Saint Paul/Ramsey County CoC,1438,269,1169,743.0,698.0
2017,MN-502,Rochester/Southeast Minnesota CoC,552,38,514,498.474358974359,525.7521367521367
2017,MN-503,"Dakota, Anoka, Washington, Scott, Carver Counties",544,74,470,743.0,620.4861111111111
2017,MN-504,Northeast Minnesota CoC,99,8,91,517.8666666666667,500.0190476190476
2017,MN-505,St. Cloud/Central Minnesota CoC,862,17,845,628.1530612244898,538.7057823129252
2017,MN-506,Northwest Minnesota CoC,288,2,286,461.5,489.8833333333333
2017,MN-508,Moorhead/West Central Minnesota CoC,215,18,197,454.12666666666667,472.9866666666667
2017,MN-509,Duluth/St.Louis County CoC,505,138,367,560.0,518.0
2017,MN-511,Southwest Minnesota CoC,108,0,108,469.01460113960115,523.8354700854701
2017,MO-500,St. Louis County CoC,462,73,389,650.0,595.0
2017,MO-501,St.Louis City CoC,1336,151,1185,650.0,595.0
2017,MO-503,"St. Charles City & County, Lincoln, Warren Counties CoC",578,36,542,650.0,563.5555555555555
2017,MO-600,"Springfield/Greene, Christian, Webster Counties CoC",455,190,265,534.0,464.25
2017,MO-602,"Joplin/Jasper, Newton Counties CoC",270,45,225,547.0,486.4444444444444
2017,MO-603,"St. Joseph/Andrew, Buchanan, DeKalb Counties CoC",210,62,148,540.0,505.83333333333337
2017,MO-606,Missouri Balance of State CoC,1244,245,999,489.13553303674405,507.52432031636187
2017,MS-500,"Jackson/Rankin, Madison Counties CoC",511,20,491,651.0526315789473,451.1140350877193
2017,MS-501,Mississippi Balance of State CoC,697,33,664,539.0836948139579,533.4432234432235
2017,MS-503,Gulf Port/Gulf Coast Regional CoC,264,19,245,645.7797619047619,645.7380952380952
2017,MT-500,Montana Statewide CoC,1529,198,1331,529.5272727272728,548.1969696969697
2017,NC-500,Winston-Salem/Forsyth County CoC,453,60,393,644.0,570.1666666666667
2017,NC-501,Asheville/Buncombe County CoC,562,83,479,765.0,567.25
2017,NC-502,Durham City & County CoC,354,50,304,757.0,651.8888888888888
2017,NC-503,North Carolina Balance of State CoC,3054,382,2672,606.6569026806526,578.014000068559
2017,NC-504,"Greensboro, High Point CoC",573,30,543,614.0,585.0
2017,NC-505,Charlotte/Mecklenberg CoC,1476,147,1329,751.0,596.3888888888888
2017,NC-506,"Wilmington/Brunswick, New Hanover, Pender Counties CoC",322,44,278,718.0,604.3333333333334
2017,NC-507,Raleigh/Wake County CoC,884,91,793,739.0,654.5833333333333
2017,NC-509,"Gastonia/Cleveland, Gaston, Lincoln Counties CoC",249,25,224,610.8000000000001,622.4666666666667
2017,NC-511,Fayetteville/Cumberland County CoC,442,136,306,723.0,527.6666666666666
2017,NC-513,Chapel Hill/Orange County CoC,127,14,113,757.0,635.25
2017,NC-516,Northwest North Carolina CoC,466,13,453,530.5508241758241,519.8241758241759
2017,ND-500,North Dakota Statewide CoC,1089,45,1044,636.1785037878789,455.45643939393943
2017,NE-500,Nebraska Balance of State CoC,506,10,496,466.51633852258857,495.5082264957265
2017,NE-501,"Omaha, Council Bluffs CoC",1389,290,1099,603.0,507.33333333333337
2017,NE-502,Lincoln CoC,606,75,531,559.0,457.5
2017,NH-500,New Hampshire Balance of State CoC,767,106,661,805.7567567567567,776.9395013159137
2017,NH-502,Nashua/Hillsborough County CoC,295,13,282,739.8709677419355,849.5106812695047
2017,NJ-500,Atlantic City & County CoC,422,104,318,979.0,857.1666666666666
2017,NJ-501,Bergen County CoC,302,3,299,1178.0,1236.1666666666667
2017,NJ-502,Burlington County CoC,604,109,495,845.0,883.7142857142857
2017,NJ-503,"Camden City & County/Gloucester, Cape May, Cumberland Counties CoC",938,85,853,838.9583333333334,823.2083333333334
2017,NJ-504,Newark/Essex County CoC,2048,181,1867,1081.0,1148.2
2017,NJ-506,"Jersey City, Bayonne/Hudson County CoC",822,174,648,1242.0,1208.75
2017,NJ-507,New Brunswick/Middlesex County CoC,546,69,477,1122.0,1097.2
2017,NJ-508,Monmouth County CoC,299,44,255,1010.0,1039.2
2017,NJ-509,Morris County CoC,378,71,307,1081.0,1097.0
2017,NJ-510,Lakewood Township/Ocean County CoC,224,24,200,1010.0,880.6666666666666
2017,NJ-511,Paterson/Passaic County CoC,449,58,391,1178.0,1141.5
2017,NJ-513,Somerset County CoC,244,3,241,1122.0,1055.8
2017,NJ-514,Trenton/Mercer County CoC,478,69,409,1011.0,966.6666666666666
2017,NJ-515,Elizabeth/Union County CoC,480,43,437,1081.0,1156.3333333333333
2017,NJ-516,"Warren, Sussex, Hunterdon Counties CoC",286,32,254,1052.642857142857,965.5714285714286
2017,NM-501,New Mexico Balance of State CoC,1164,435,729,567.7354797979798,532.3134018759018
2017,NV-500,Las Vegas/Clark County CoC,6490,446,6044,669.0,642.125
2017,NV-501,"Reno, Sparks/Washoe County CoC",1106,38,1068,624.0,653.7
2017,NV-502,Nevada Balance of State CoC,237,28,209,539.5612874779541,629.2896825396825
2017,NY-500,"Rochester, Irondequoit, Greece/Monroe County CoC",817,184,633,663.0,595.8333333333334
2017,NY-501,"Elmira/Steuben, Allegany, Livingston, Chemung, Schuyler Counties CoC",226,6,220,599.6583333333333,566.5583333333334
2017,NY-503,Albany City & County CoC,802,82,720,734.0,725.0
2017,NY-505,"Syracuse, Auburn/Onondaga, Oswego, Cayuga Counties CoC",798,43,755,592.1666666666667,667.3666666666666
2017,NY-507,Schenectady City & County CoC,274,15,259,734.0,709.3333333333334
2017,NY-508,"Buffalo, Niagara Falls/Erie, Niagara, Orleans, Genesee, Wyoming Counties CoC",925,24,901,614.7083333333334,564.5
2017,NY-510,Ithaca/Tompkins County CoC,73,5,68,909.0,556.75
2017,NY-511,"Binghamton, Union Town/Broome, Otsego, Chenango, Delaware, Cortland, Tioga Count",308,5,303,622.71875,663.00625
2017,NY-512,Troy/Rensselaer County CoC,194,18,176,734.0,723.7375
2017,NY-513,"Wayne, Ontario, Seneca, Yates Counties CoC",337,29,308,609.35,660.25
2017,NY-514,"Jamestown, Dunkirk/Chautauqua County CoC",83,0,83,571.0,564.25
2017,NY-518,"Utica, Rome/Oneida, Madison Counties CoC",162,8,154,653.9791666666666,596.625
2017,NY-519,"Columbia, Greene Counties CoC",144,15,129,717.0,741.8125
2017,NY-520,"Franklin, Essex Counties CoC",28,1,27,590.9,651.9
2017,NY-522,"Jefferson, Lewis, St. Lawrence Counties CoC",169,12,157,663.4666666666667,576.2666666666667
2017,NY-523,"Glens Falls, Saratoga Springs/Saratoga, Washington, Warren, Hamilton Counties Co",247,12,235,685.7142857142857,670.0119047619047
2017,NY-600,New York City CoC,76501,5755,70746,1475.0,1097.2857142857142
2017,NY-601,Poughkeepsie/Dutchess County CoC,388,6,382,908.0,917.5454192546584
2017,NY-602,"Newburgh, Middletown/Orange County CoC",350,17,333,908.0,1052.2142857142858
2017,NY-603,"Nassau, Suffolk Counties CoC",3937,141,3796,1330.0,1045.5405843110188
2017,NY-604,"Yonkers, Mount Vernon/Westchester County CoC",1832,149,1683,1288.0,1278.6884057971015
2017,NY-606,Rockland County CoC,170,28,142,1475.0,1156.6
2017,NY-608,Kingston/Ulster County CoC,411,14,397,768.0,771.0
2017,OH-500,Cincinnati/Hamilton County CoC,1162,90,1072,565.0,531.0
2017,OH-501,Toledo/Lucas County CoC,499,38,461,495.0,538.0833333333334
2017,OH-502,Cleveland/Cuyahoga County CoC,1727,120,1607,561.0,539.8
2017,OH-503,Columbus/Franklin County CoC,1691,229,1462,617.0,567.0
2017,OH-504,Youngstown/Mahoning County CoC,262,16,246,485.0,476.77777777777777
2017,OH-505,"Dayton, Kettering/Montgomery County CoC",619,30,589,557.0,529.2857142857143
2017,OH-506,"Akron, Barberton/Summit County CoC",507,56,451,555.0,503.3333333333333
2017,OH-507,Ohio Balance of State CoC,3309,180,3129,522.515406162465,514.8821713870733
2017,OH-508,"Canton, Massillon, Alliance/Stark County CoC",319,13,306,517.0,507.0555555555556
2017,OK-500,North Central Oklahoma CoC,192,6,186,539.7333333333333,478.4666666666667
2017,OK-501,Tulsa City & County CoC,1074,137,937,569.0,472.88888888888886
2017,OK-502,Oklahoma City CoC,1368,254,1114,605.0,542.6666666666666
2017,OK-503,Oklahoma Balance of State CoC,432,36,396,502.3066239316239,516.3430674264007
2017,OK-504,Norman/Cleveland County CoC,174,111,63,605.0,576.0
2017,OK-505,Northeast Oklahoma CoC,377,41,336,520.6632653061224,506.01020408163265
2017,OK-506,Southwest Oklahoma Regional CoC,231,0,231,509.025,520.3729166666667
2017,OK-507,Southeastern Oklahoma Regional CoC,351,75,276,475.27708333333334,509.7833333333333
2017,OR-500,"Eugene, Springfield/Lane County CoC",1529,640,889,598.0,615.6
2017,OR-501,"Portland, Gresham/Multnomah County CoC",4177,1290,2887,1030.0,902.5
2017,OR-502,"Medford, Ashland/Jackson County CoC",633,170,463,645.0,549.0
2017,OR-503,Central Oregon CoC,778,246,532,597.4,543.2666666666667
2017,OR-505,Oregon Balance of State CoC,5795,737,5058,596.4217592592593,677.6606481481481
2017,OR-506,"Hillsboro, Beaverton/Washington County CoC",544,150,394,1030.0,899.5833333333334
2017,OR-507,Clackamas County CoC,497,154,343,1030.0,798.8333333333334
2017,PA-500,Philadelphia CoC,5693,898,4795,845.0,830.0
2017,PA-501,Harrisburg/Dauphin County CoC,460,45,415,650.0,596.8888888888888
2017,PA-502,"Upper Darby, Chester, Haverford/Delaware County CoC",453,26,427,845.0,830.0
2017,PA-503,"Wilkes-Barre, Hazleton/Luzerne County CoC",174,0,174,591.0,513.1666666666667
2017,PA-504,"Lower Merion, Norristown, Abington/Montgomery County CoC",310,40,270,845.0,759.8333333333334
2017,PA-505,Chester County CoC,578,12,566,845.0,758.5
2017,PA-506,Reading/Berks County CoC,534,2,532,650.0,717.8333333333334
2017,PA-508,Scranton/Lackawanna County CoC,197,13,184,591.0,516.625
2017,PA-509,Eastern Pennsylvania CoC,2170,156,2014,652.5802083333333,669.8416666666667
2017,PA-510,Lancaster City & County CoC,321,6,315,672.0,686.9166666666666
2017,PA-511,"Bristol, Bensalem/Bucks County CoC",511,27,484,845.0,836.8333333333334
2017,PA-512,York City & County CoC,288,12,276,612.0,750.75
2017,PA-600,"Pittsburgh, McKeesport, Penn Hills/Allegheny County CoC",1145,131,1014,609.0,597.0
2017,PA-601,Western Pennsylvania CoC,837,29,808,569.9722222222223,534.1944444444445
2017,PA-603,Beaver County CoC,98,12,86,609.0,516.6666666666666
2017,PA-605,Erie City & County CoC,369,29,340,614.0,527.6666666666666
2017,PR-502,Puerto Rico Balance of Commonwealth CoC,1883,655,1228,403.2352941176471,420.6764705882353
2017,PR-503,South-Southeast Puerto Rico CoC,1642,423,1219,413.9117647058824,398.8529411764706
2017,RI-500,Rhode Island Statewide CoC,1180,240,940,794.4,874.4904761904763
2017,SC-500,Charleston/Low Country CoC,425,108,317,671.8690476190477,580.077380952381
2017,SC-501,"Greenville, Anderson, Spartanburg/Upstate CoC",1317,230,1087,555.0055555555556,548.0
2017,SC-502,Columbia/Midlands CoC,1200,295,905,599.3968253968253,591.4260204081633
2017,SC-503,"Myrtle Beach, Sumter City & County CoC",974,191,783,604.2301136363636,641.5397727272727
2017,SD-500,South Dakota Statewide CoC,943,144,799,476.84968602825745,468.08048796441653
2017,TN-500,Chattanooga/Southeast Tennessee CoC,576,192,384,500.079365079365,494.02777777777777
2017,TN-501,Memphis/Shelby County CoC,1426,66,1360,675.0,596.5
2017,TN-502,Knoxville/Knox County CoC,812,77,735,555.0,495.8571428571429
2017,TN-503,Central Tennessee CoC,285,45,240,570.1142857142856,552.4696428571428
2017,TN-504,Nashville-Davidson County CoC,2337,617,1720,740.0,700.0
2017,TN-506,Upper Cumberland CoC,252,25,227,563.075283446712,567.8131519274376
2017,TN-507,Jackson/West Tennessee CoC,1103,212,891,528.1095238095238,506.80357142857144
2017,TN-509,Appalachian Regional CoC,450,73,377,480.30357142857144,520.9642857142858
2017,TN-510,Murfreesboro/Rutherford County CoC,316,73,243,740.0,645.5833333333334
2017,TN-512,"Morristown/Blount, Sevier, Campbell, Cocke Counties CoC",752,104,648,486.3224489795918,486.6345238095238
2017,TX-500,San Antonio/Bexar County CoC,2743,651,2092,664.0,603.1428571428571
2017,TX-503,Austin/Travis County CoC,2036,553,1483,859.0,730.8333333333334
2017,TX-600,"Dallas City & County, Irving CoC",3789,542,3247,745.0,647.9444444444445
2017,TX-601,"Fort Worth, Arlington/Tarrant County CoC",1941,234,1707,715.0,652.1666666666666
2017,TX-603,El Paso City & County CoC,1193,96,1097,590.0,524.0
2017,TX-604,Waco/McLennan County CoC,221,26,195,538.8,598.1
2017,TX-607,Texas Balance of State CoC,7153,879,6274,608.9850355526825,584.6280381383322
2017,TX-624,"Wichita Falls/Wise, Palo Pinto, Wichita, Archer Counties CoC",234,65,169,628.807738095238,541.7904761904763
2017,TX-700,"Houston, Pasadena, Conroe/Harris, Ft. Bend, Montgomery, Counties CoC",3605,539,3066,752.0,593.3076923076924
2017,TX-701,"Bryan, College Station/Brazos Valley CoC",102,14,88,591.6051282051282,617.9589743589744
2017,UT-500,Salt Lake City & County CoC,2047,143,1904,675.0,612.3333333333333
2017,UT-503,Utah Balance of State CoC,634,34,600,506.75069444444443,609.4444444444445
2017,UT-504,Provo/Mountainland CoC,171,8,163,719.0777777777779,599.5
2017,VA-500,"Richmond/Henrico, Chesterfield, Hanover Counties CoC",662,76,586,886.0,830.8333333333334
2017,VA-501,"Norfolk, Chesapeake, Suffolk/Isle of Wight, Southampton Counties CoC",703,82,621,852.9523809523808,784.8809523809524
2017,VA-502,"Roanoke City & County, Salem CoC",267,48,219,579.0,543.4861111111111
2017,VA-503,Virginia Beach CoC,349,62,287,934.0,947.0
2017,VA-504,Charlottesville CoC,160,55,105,761.4545454545455,676.8106060606061
2017,VA-505,"Newport News, Hampton/Virginia Peninsula CoC",512,75,437,934.0,862.1666666666666
2017,VA-508,Lynchburg CoC,125,27,98,614.0,634.1
2017,VA-513,"Harrisburg, Winchester/Western Virginia CoC",280,44,236,673.9484126984127,682.1547619047619
2017,VA-514,"Fredericksburg/Spotsylvania, Stafford Counties CoC",216,29,187,863.6,769.3
2017,VA-521,Virginia Balance of State CoC,722,39,683,600.1269047792485,642.057728035853
2017,VA-603,Alexandria CoC,211,43,168,1440.0,1307.0
2017,VT-500,Vermont Balance of State CoC,934,83,851,840.5357142857143,662.6458333333334
2017,VT-501,Burlington/Chittenden County CoC,291,44,247,957.0,608.5333333333333
2017,WA-500,Seattle/King County CoC,11643,2773,8870,1184.0,818.8888888888888
2017,WA-501,Washington Balance of State CoC,5243,1031,4212,584.46875,771.7465277777777
2017,WA-502,Spokane City & County CoC,1090,325,765,551.0,530.7083333333333
2017,WA-503,"Tacoma, Lakewood/Pierce County CoC",1321,337,984,766.0,883.875
2017,WA-504,Everett/Snohomish County CoC,1066,387,679,1184.0,881.0
2017,WI-500,Wisconsin Balance of State CoC,3348,232,3116,558.0606766917293,612.8376998050682
2017,WI-501,Milwaukee City & County CoC,900,98,802,615.0,592.5
2017,WI-502,Racine City & County CoC,194,17,177,577.0,589.1666666666666
2017,WI-503,Madison/Dane County CoC,585,87,498,714.0,559.8571428571429
2017,WV-500,"Wheeling, Weirton Area CoC",118,23,95,570.15,547.4333333333334
2017,WV-501,"Huntington/Cabell, Wayne Counties CoC",205,9,196,497.0,494.1666666666667
2017,WV-503,"Charleston/Kanawha, Putnam, Boone, Clay Counties CoC",319,65,254,606.1176470588235,447.0
2017,WV-508,West Virginia Balance of State CoC,667,109,558,571.2929255548373,523.6173319327731
2017,WY-500,Wyoming Statewide CoC,873,68,805,583.8794913419913,592.5273268398269
2016,AK-500,Anchorage CoC,1105,50,1055,940.0,694.0
2016,AK-501,Alaska Balance of State CoC,835,72,763,655.0,866.0
2016,AL-500,"Birmingham/Jefferson, St. Clair, Shelby Counties CoC",1228,92,1136,666.0,507.3333333333333
2016,AL-501,Mobile City & County/Baldwin County CoC,623,80,543,729.85,550.8
2016,AL-502,Florence/Northwest Alabama CoC,337,39,298,475.33333333333337,461.4333333333334
2016,AL-503,Huntsville/North Alabama CoC,385,102,283,542.75,454.35416666666663
2016,AL-504,Montgomery City & County CoC,367,28,339,573.6875,459.1875
2016,AL-506,Tuscaloosa City & County CoC,177,13,164,608.0,549.0
2016,AL-507,Alabama Balance of State CoC,827,44,783,501.5497988939165,558.103544494721
2016,AR-500,Little Rock/Central Arkansas CoC,808,208,600,540.1666666666667,475.3
2016,AR-501,Fayetteville/Northwest Arkansas CoC,550,90,460,555.6,449.4166666666667
2016,AR-503,Arkansas  Balance of State  CoC,850,125,725,488.3653921568627,520.4520588235295
2016,AR-505,Southeast Arkansas CoC,89,26,63,490.1890476190476,497.7338095238095
2016,AZ-500,Arizona Balance of State CoC,2240,437,1803,582.5958333333333,591.475
2016,AZ-501,Tucson/Pima County CoC,1765,213,1552,565.0,605.9
2016,AZ-502,"Phoenix, Mesa/Maricopa County CoC",5702,745,4957,635.0,569.8
2016,CA-500,San Jose/Santa Clara City & County CoC,6524,2146,4378,1471.0,935.1666666666666
2016,CA-501,San Francisco CoC,6996,1932,5064,1559.0,1249.0
2016,CA-502,"Oakland, Berkeley/Alameda County CoC",4145,753,3392,1487.0,1075.5
2016,CA-503,Sacramento City & County CoC,2500,540,1960,754.0,758.875
2016,CA-504,"Santa Rosa, Petaluma/Sonoma County CoC",2906,747,2159,1000.0,974.3333333333334
2016,CA-505,Richmond/Contra Costa County CoC,1730,384,1346,1487.0,1002.4285714285714
2016,CA-506,"Salinas/Monterey, San Benito Counties CoC",3022,660,2362,1008.5,857.6666666666666
2016,CA-507,Marin County CoC,1258,257,1001,1559.0,1067.5
2016,CA-508,Watsonville/Santa Cruz City & County CoC,1959,573,1386,1064.0,1192.1666666666667
2016,CA-509,Mendocino County CoC,1242,177,1065,781.0,690.0
2016,CA-510,"Turlock, Modesto/Stanislaus County CoC",1434,361,1073,671.0,852.6666666666666
2016,CA-511,Stockton/San Joaquin County CoC,1780,247,1533,652.0,849.2
2016,CA-512,Daly/San Mateo County CoC,1361,238,1123,1559.0,1240.25
2016,CA-513,"Visalia/Kings, Tulare Counties CoC",792,251,541,637.4,801.4
2016,CA-514,Fresno City & County/Madera County CoC,1883,546,1337,722.5,696.8333333333333
2016,CA-515,"Roseville, Rocklin/Placer County CoC",1021,347,674,754.0,716.6666666666666
2016,CA-516,"Redding/Shasta, Siskiyou, Lassen, Plumas, Del Norte, Modoc, Sierra Counties CoC",1272,425,847,677.7222222222222,640.9814814814814
2016,CA-517,Napa City & County CoC,317,98,219,994.0,819.0
2016,CA-518,Vallejo/Solano County CoC,1118,259,859,883.0,995.0
2016,CA-519,"Chico, Paradise/Butte County CoC",574,251,323,661.0,564.125
2016,CA-520,Merced City & County CoC,516,224,292,548.0,820.2
2016,CA-521,"Davis, Woodland/Yolo County CoC",532,89,443,931.0,730.6666666666666
2016,CA-522,Humboldt County CoC,1134,377,757,720.0,707.5
2016,CA-523,"Colusa, Glenn, Trinity Counties CoC",115,33,82,631.375,668.4375
2016,CA-524,Yuba City & County/Sutter County CoC,702,233,469,663.0,742.7142857142857
2016,CA-525,El Dorado County CoC,269,139,130,754.0,658.0
2016,CA-526,"Amador, Calaveras, Mariposa, Tuolumne Counties CoC",632,129,503,710.1428571428571,658.7142857142857
2016,CA-600,Los Angeles City & County CoC,43854,13468,30386,1026.0,924.25
2016,CA-601,San Diego City and County CoC,8669,1417,7252,1134.0,826.3333333333334
2016,CA-602,"Santa Ana, Anaheim/Orange County CoC",4319,716,3603,1245.0,904.5
2016,CA-603,Santa Maria/Santa Barbara County CoC,1813,453,1360,1206.0,883.0
2016,CA-604,Bakersfield/Kern County CoC,1067,272,795,643.0,888.7142857142857
2016,CA-608,Riverside City & County CoC,2165,378,1787,798.0,819.2
2016,CA-609,San Bernardino City & County CoC,1887,405,1482,798.0,803.5
2016,CA-611,"Oxnard, San Buenaventura/Ventura County CoC",1271,303,968,1063.0,927.6666666666666
2016,CA-613,Imperial County CoC,380,60,320,546.0,814.8333333333334
2016,CA-614,San Luis Obispo County CoC,1368,418,950,917.0,816.5
2016,CO-500,Colorado Balance of State CoC,3520,703,2817,604.1901320901321,524.0448756798755
2016,CO-503,Metropolitan Denver CoC,5728,739,4989,838.2051282051283,593.2307692307692
2016,CO-504,Colorado Springs/El Paso County CoC,1302,387,915,596.0,652.2
2016,CT-503,"Bridgeport, Stamford, Norwalk, Danbury/Fairfield County CoC",886,98,788,1143.1304347826087,1083.0
2016,CT-505,Connecticut Balance of State CoC,3016,369,2647,723.7875661375662,854.3443064182195
2016,DE-500,Delaware Statewide CoC,1070,74,996,797.3690476190477,765.7261904761906
2016,FL-500,"Sarasota, Bradenton/Manatee, Sarasota Counties CoC",1468,311,1157,757.0,610.9166666666666
2016,FL-501,Tampa/Hillsborough County CoC,1817,254,1563,712.0,652.4
2016,FL-502,"St. Petersburg, Clearwater, Largo/Pinellas County CoC",2777,607,2170,712.0,650.0
2016,FL-503,"Lakeland, Winterhaven/Polk County CoC",635,88,547,732.0,675.4166666666666
2016,FL-504,"Deltona, Daytona Beach/Volusia, Flagler Counties CoC",1005,210,795,590.5,636.8333333333334
2016,FL-505,"Fort Walton Beach/Okaloosa, Walton Counties CoC",629,306,323,720.5,547.5833333333334
2016,FL-506,Tallahassee/Leon County CoC,869,81,788,627.4074074074075,536.0277777777778
2016,FL-507,"Orlando/Orange, Osceola, Seminole Counties CoC",1670,106,1564,789.0,625.25
2016,FL-508,"Gainesville/Alachua, Putnam Counties CoC",844,265,579,574.6944444444445,608.7083333333334
2016,FL-509,"Fort Pierce/St. Lucie, Indian River, Martin Counties CoC",2382,77,2305,677.55,663.25
2016,FL-510,"Jacksonville-Duval, Clay Counties CoC",1959,337,1622,658.0,591.6666666666666
2016,FL-511,"Pensacola/Escambia, Santa Rosa Counties CoC",798,216,582,738.0,600.0
2016,FL-512,St. Johns County CoC,1064,35,1029,658.0,627.6666666666666
2016,FL-513,"Palm Bay, Melbourne/Brevard County CoC",827,193,634,572.0,638.0
2016,FL-514,Ocala/Marion County CoC,823,65,758,590.0,634.2222222222222
2016,FL-515,"Panama City/Bay, Jackson Counties CoC",310,30,280,515.625,581.6666666666666
2016,FL-517,"Hendry, Hardee, Highlands Counties CoC",1071,335,736,597.94,705.3
2016,FL-518,"Columbia, Hamilton, Lafayette, Suwannee Counties CoC",1145,216,929,588.4666666666667,636.8833333333333
2016,FL-519,Pasco County CoC,1055,404,651,712.0,664.375
2016,FL-520,"Citrus, Hernando, Lake, Sumter Counties CoC",595,33,562,695.4722222222223,631.3333333333334
2016,FL-600,Miami-Dade County CoC,4235,472,3763,829.0,939.6666666666666
2016,FL-601,Ft Lauderdale/Broward County CoC,2302,430,1872,823.0,719.25
2016,FL-602,Punta Gorda/Charlotte County CoC,388,76,312,644.0,688.75
2016,FL-603,"Ft Myers, Cape Coral/Lee County CoC",439,90,349,728.0,633.3333333333334
2016,FL-604,Monroe County CoC,575,126,449,1096.0,773.5
2016,FL-605,West Palm Beach/Palm Beach County CoC,1332,459,873,765.0,696.1111111111112
2016,FL-606,Naples/Collier County CoC,545,73,472,765.0,841.0
2016,GA-500,Atlanta CoC,4063,556,3507,813.0,755.0
2016,GA-501,Georgia Balance of State CoC,5575,883,4692,623.0300653594771,597.6991157247212
2016,GA-503,Athens-Clarke County CoC,224,49,175,619.0,612.4
2016,GA-504,Augusta-Richmond County CoC,287,42,245,570.0,564.6666666666666
2016,GA-505,Columbus-Muscogee CoC,329,35,294,648.0,610.8333333333333
2016,GA-506,Marietta/Cobb County CoC,405,43,362,813.0,755.0
2016,GA-507,Savannah/Chatham County CoC,1070,155,915,702.0,567.3333333333333
2016,GA-508,DeKalb County CoC,473,24,449,813.0,755.0
2016,IA-500,"Sioux City/Dakota, Woodbury Counties CoC",348,17,331,468.0,418.33333333333337
2016,IA-501,Iowa Balance of State CoC,1923,101,1822,464.5495504495504,466.7035853035852
2016,IA-502,Des Moines/Polk County CoC,793,66,727,610.0,515.7142857142857
2016,ID-500,Boise/Ada County CoC,867,140,727,511.0,465.6
2016,ID-501,Idaho Balance of State CoC,1380,197,1183,516.0951388888889,522.0444444444445
2016,IL-500,McHenry County CoC,154,7,147,860.0,721.8
2016,IL-501,"Rockford/DeKalb, Winnebago, Boone Counties CoC",336,47,289,600.8,679.1
2016,IL-502,"Waukegan, North Chicago/Lake County CoC",299,32,267,860.0,697.0
2016,IL-503,"Champaign, Urbana, Rantoul/Champaign County CoC",188,5,183,573.0,528.875
2016,IL-506,"Joliet, Bolingbrook/Will County CoC",290,17,273,794.9761904761906,650.2857142857143
2016,IL-507,"Peoria, Pekin/Fulton, Tazewell, Peoria, Woodford Counties CoC",378,92,286,480.5555555555555,458.3888888888889
2016,IL-511,Cook County CoC,952,128,824,860.0,727.5714285714286
2016,IL-512,Bloomington/Central Illinois CoC,411,83,328,488.5687830687831,499.94444444444446
2016,IL-513,Springfield/Sangamon County CoC,261,38,223,553.0,452.2083333333333
2016,IL-514,DuPage County CoC,555,37,518,860.0,801.3333333333334
2016,IL-515,South Central Illinois CoC,133,5,128,477.0722222222222,488.4641975308641
2016,IL-516,Decatur/Macon County CoC,157,23,134,455.0,472.88888888888886
2016,IL-517,"Aurora, Elgin/Kane County CoC",355,76,279,860.0,756.6
2016,IL-518,"Rock Island, Moline/Northwestern Illinois CoC",340,0,340,465.6292517006803,499.0850340136054
2016,IL-519,West Central Illinois CoC,102,3,99,449.9680272108844,461.11156462585035
2016,IL-520,Southern Illinois CoC,351,24,327,440.5854166666667,456.0229166666667
2016,IN-502,Indiana Balance of State CoC,4179,427,3752,528.9309243697479,557.7964425770308
2016,IN-503,Indianapolis CoC,1619,162,1457,589.0,549.0
2016,KS-502,Wichita/Sedgwick County CoC,571,39,532,486.0,465.1666666666667
2016,KS-503,Topeka/Shawnee County CoC,381,194,187,475.0,487.1666666666667
2016,KS-507,Kansas Balance of State CoC,903,85,818,503.3022394272394,475.40630203130206
2016,KY-500,Kentucky Balance of State CoC,2057,93,1964,501.70895691609974,463.4214285714285
2016,KY-501,Louisville-Jefferson County CoC,1116,186,930,584.0,555.8
2016,KY-502,Lexington-Fayette County CoC,1064,103,961,568.0,535.5
2016,LA-500,Lafayette/Acadiana CoC,463,62,401,438.6794871794872,503.61538461538464
2016,LA-502,"Shreveport, Bossier/Northwest Louisiana CoC",478,17,461,534.6805555555555,504.79166666666674
2016,LA-503,New Orleans/Jefferson Parish CoC,1626,403,1223,711.0,675.8333333333333
2016,LA-505,Monroe/Northeast Louisiana CoC,188,8,180,472.03809523809525,493.3642857142857
2016,LA-506,Slidell/Southeast Louisiana CoC,275,24,251,635.8854166666666,583.4583333333334
2016,LA-507,Alexandria/Central Louisiana CoC,167,7,160,480.3035714285714,482.4464285714286
2016,LA-509,Louisiana Balance of State CoC,797,49,748,596.9715544871794,567.2267628205129
2016,MA-500,Boston CoC,6240,919,5321,1148.0,1070.2119773835461
2016,MA-503,Cape Cod Islands CoC,394,56,338,1047.5,907.9101851851852
2016,MA-504,Springfield/Hampden County CoC,2385,170,2215,672.0,696.15
2016,MA-506,Worcester City & County CoC,1572,65,1507,719.3166666666667,751.9629545228623
2016,MA-507,"Pittsfield/Berkshire, Franklin, Hampshire Counties CoC",653,80,573,736.4674479166666,738.525
2016,MA-511,"Quincy, Brockton, Weymouth, Plymouth City and County CoC",1692,270,1422,1012.6666666666666,995.6303571428571
2016,MA-516,Massachusetts Balance of State CoC,4516,484,4032,1107.7211162242675,863.8581846823781
2016,MA-519,"Attleboro, Taunton/Bristol County CoC",243,30,213,747.85,943.7354497354497
2016,MD-501,Baltimore CoC,2725,605,2120,851.0,833.0
2016,MD-503,Annapolis/Anne Arundel County CoC,390,70,320,851.0,821.3333333333334
2016,MD-505,Baltimore County CoC,763,108,655,851.0,760.5
2016,MD-506,Carroll County CoC,136,10,126,851.0,666.3333333333334
2016,MD-511,Mid-Shore Regional CoC,138,23,115,727.3666666666666,755.5
2016,MD-513,"Wicomico, Somerset, Worcester Counties CoC",262,33,229,587.5416666666666,757.1666666666666
2016,MD-514,Maryland Balance of State CoC,1536,297,1239,754.3522727272727,637.3939393939395
2016,ME-500,Maine Statewide CoC,2241,217,2024,663.8689655172413,745.9135135135135
2016,MI-500,Michigan Balance of State CoC,1536,44,1492,520.5570175438596,547.7483851674641
2016,MI-502,"Dearborn, Dearborn Heights, Westland/Wayne County CoC",277,9,268,572.0,581.75
2016,MI-503,"St. Clair Shores, Warren/Macomb County CoC",403,14,389,572.0,548.0
2016,MI-504,"Pontiac, Royal Oak/Oakland County CoC",438,37,401,572.0,564.0
2016,MI-505,Flint/Genesee County CoC,377,24,353,480.0,501.0
2016,MI-506,"Grand Rapids, Wyoming/Kent County CoC",800,63,737,554.0,538.1999999999999
2016,MI-507,"Portage, Kalamazoo City & County CoC",374,18,356,535.0,487.6666666666667
2016,MI-508,"Lansing, East Lansing/Ingham County CoC",471,44,427,586.0,518.375
2016,MI-509,Washtenaw County CoC,342,63,279,832.0,554.3333333333334
2016,MI-510,Saginaw City & County CoC,343,22,321,461.0,463.6
2016,MI-511,Lenawee County CoC,137,16,121,567.0,503.3333333333333
2016,MI-512,"Grand Traverse, Antrim, Leelanau Counties CoC",243,38,205,580.3645833333333,465.02083333333337
2016,MI-514,Battle Creek/Calhoun County CoC,246,25,221,470.0,504.8125
2016,MI-515,Monroe City & County CoC,176,11,165,558.0,590.5
2016,MI-516,"Norton Shores, Muskegon City & County CoC",191,5,186,544.0,570.5
2016,MI-517,Jackson City & County CoC,169,2,167,488.0,548.7142857142857
2016,MI-518,Livingston County CoC,77,1,76,590.0,531.5
2016,MI-519,Holland/Ottawa County CoC,261,9,252,543.0,557.4
2016,MI-523,Eaton County CoC,120,2,118,586.0,500.16666666666663
2016,MN-500,Minneapolis/Hennepin County CoC,3056,390,2666,698.0,683.0
2016,MN-501,Saint Paul/Ramsey County CoC,1346,210,1136,698.0,683.0
2016,MN-502,Rochester/Southeast Minnesota CoC,423,35,388,487.01175213675214,504.30128205128204
2016,MN-503,"Dakota, Anoka, Washington, Scott, Carver Counties",618,57,561,698.0,618.1111111111112
2016,MN-504,Northeast Minnesota CoC,77,2,75,525.3047619047619,485.0857142857143
2016,MN-505,St. Cloud/Central Minnesota CoC,669,18,651,610.7993197278912,532.8911564625851
2016,MN-506,Northwest Minnesota CoC,290,22,268,451.7583333333334,467.8333333333333
2016,MN-508,Moorhead/West Central Minnesota CoC,211,24,187,442.67333333333335,468.28000000000003
2016,MN-509,Duluth/St.Louis County CoC,528,110,418,533.0,497.6
2016,MN-511,Southwest Minnesota CoC,123,5,118,453.3326923076923,528.528774928775
2016,MO-500,St. Louis County CoC,465,18,447,595.0,567.0
2016,MO-501,St.Louis City CoC,1248,168,1080,595.0,567.0
2016,MO-503,"St. Charles City & County, Lincoln, Warren Counties CoC",610,33,577,595.0,534.1111111111111
2016,MO-600,"Springfield/Greene, Christian, Webster Counties CoC",496,221,275,497.0,433.3333333333333
2016,MO-602,"Joplin/Jasper, Newton Counties CoC",297,19,278,519.0,453.38888888888886
2016,MO-603,"St. Joseph/Andrew, Buchanan, DeKalb Counties CoC",195,45,150,520.0,481.1111111111111
2016,MO-606,Missouri Balance of State CoC,1431,201,1230,474.10587136815514,482.764335145823
2016,MS-500,"Jackson/Rankin, Madison Counties CoC",633,88,545,590.0,447.8421052631579
2016,MS-501,Mississippi Balance of State CoC,785,57,728,514.6517013688067,529.4433680354733
2016,MS-503,Gulf Port/Gulf Coast Regional CoC,320,38,282,591.2738095238095,630.297619047619
2016,MT-500,Montana Statewide CoC,1418,137,1281,502.4212121212121,525.6606060606061
2016,NC-500,Winston-Salem/Forsyth County CoC,544,95,449,596.0,547.4166666666667
2016,NC-501,Asheville/Buncombe County CoC,509,74,435,632.0,510.25
2016,NC-502,Durham City & County CoC,354,57,297,684.0,640.8888888888888
2016,NC-503,North Carolina Balance of State CoC,2963,348,2615,575.1458184217743,555.3906420540244
2016,NC-504,"Greensboro, High Point CoC",721,38,683,573.0,559.9
2016,NC-505,Charlotte/Mecklenberg CoC,1818,191,1627,698.0,590.8888888888888
2016,NC-506,"Wilmington/Brunswick, New Hanover, Pender Counties CoC",389,81,308,663.25,592.6666666666666
2016,NC-507,Raleigh/Wake County CoC,818,149,669,683.0,633.6666666666667
2016,NC-509,"Gastonia/Cleveland, Gaston, Lincoln Counties CoC",328,36,292,602.8333333333334,571.8666666666667
2016,NC-511,Fayetteville/Cumberland County CoC,515,80,435,714.0,513.8333333333334
2016,NC-513,Chapel Hill/Orange County CoC,80,16,64,684.0,593.125
2016,NC-516,Northwest North Carolina CoC,520,19,501,533.493131868132,514.1428571428571
2016,ND-500,North Dakota Statewide CoC,923,120,803,558.1600378787879,471.31155303030306
2016,NE-500,Nebraska Balance of State CoC,551,7,544,449.00190018315027,472.5541971916972
2016,NE-501,"Omaha, Council Bluffs CoC",1509,200,1309,548.0,468.91666666666663
2016,NE-502,Lincoln CoC,694,26,668,506.0,436.625
2016,NH-500,New Hampshire Balance of State CoC,670,213,457,758.2016891891891,760.6590496479245
2016,NH-502,Nashua/Hillsborough County CoC,296,12,284,754.0322580645161,841.2955180670866
2016,NJ-500,Atlantic City & County CoC,476,53,423,849.0,870.0
2016,NJ-501,Bergen County CoC,296,10,286,1172.0,1191.0
2016,NJ-502,Burlington County CoC,926,133,793,830.0,901.0
2016,NJ-503,"Camden City & County/Gloucester, Cape May, Cumberland Counties CoC",1068,75,993,800.9583333333334,814.3333333333334
2016,NJ-504,Newark/Essex County CoC,1779,97,1682,1120.0,1120.6
2016,NJ-506,"Jersey City, Bayonne/Hudson County CoC",829,137,692,1157.0,1170.5
2016,NJ-507,New Brunswick/Middlesex County CoC,457,44,413,1059.0,1087.6
2016,NJ-508,Monmouth County CoC,344,74,270,963.0,1029.8
2016,NJ-509,Morris County CoC,410,34,376,1120.0,1065.9333333333334
2016,NJ-510,Lakewood Township/Ocean County CoC,429,73,356,963.0,895.6666666666666
2016,NJ-511,Paterson/Passaic County CoC,432,27,405,1172.0,1112.3333333333333
2016,NJ-513,Somerset County CoC,218,1,217,1059.0,1047.6
2016,NJ-514,Trenton/Mercer County CoC,465,20,445,921.0,948.0
2016,NJ-515,Elizabeth/Union County CoC,513,19,494,1120.0,1110.0
2016,NJ-516,"Warren, Sussex, Hunterdon Counties CoC",253,25,228,1046.357142857143,959.7142857142857
2016,NM-501,New Mexico Balance of State CoC,1041,394,647,548.4222582972583,512.626443001443
2016,NV-500,Las Vegas/Clark County CoC,6208,285,5923,670.0,634.375
2016,NV-501,"Reno, Sparks/Washoe County CoC",989,35,954,611.0,677.7
2016,NV-502,Nevada Balance of State CoC,201,27,174,525.4320987654321,602.0326278659612
2016,NY-500,"Rochester, Irondequoit, Greece/Monroe County CoC",860,184,676,611.0,599.1666666666666
2016,NY-501,"Elmira/Steuben, Allegany, Livingston, Chemung, Schuyler Counties CoC",506,117,389,576.9583333333334,571.775
2016,NY-503,Albany City & County CoC,748,83,665,730.0,734.9
2016,NY-505,"Syracuse, Auburn/Onondaga, Oswego, Cayuga Counties CoC",867,62,805,568.7666666666667,663.1666666666666
2016,NY-507,Schenectady City & County CoC,345,31,314,730.0,714.5
2016,NY-508,"Buffalo, Niagara Falls/Erie, Niagara, Orleans, Genesee, Wyoming Counties CoC",962,38,924,563.6666666666667,575.0833333333334
2016,NY-510,Ithaca/Tompkins County CoC,86,4,82,903.0,553.25
2016,NY-511,"Binghamton, Union Town/Broome, Otsego, Chenango, Delaware, Cortland, Tioga Count",276,0,276,594.5625,647.4437499999999
2016,NY-512,Troy/Rensselaer County CoC,179,19,160,730.0,681.5
2016,NY-513,"Wayne, Ontario, Seneca, Yates Counties CoC",58,33,25,560.075,649.25
2016,NY-514,"Jamestown, Dunkirk/Chautauqua County CoC",23,0,23,562.0,535.5
2016,NY-518,"Utica, Rome/Oneida, Madison Counties CoC",160,22,138,582.1041666666666,592.0
2016,NY-519,"Columbia, Greene Counties CoC",116,17,99,705.0,730.2142857142857
2016,NY-520,"Franklin, Essex Counties CoC",27,2,25,567.45,671.4
2016,NY-522,"Jefferson, Lewis, St. Lawrence Counties CoC",119,8,111,604.8333333333333,578.4
2016,NY-523,"Glens Falls, Saratoga Springs/Saratoga, Washington, Warren, Hamilton Counties Co",268,29,239,638.2857142857143,662.9047619047618
2016,NY-600,New York City CoC,73523,4294,69229,1423.0,1102.5714285714287
2016,NY-601,Poughkeepsie/Dutchess County CoC,385,21,364,894.0,914.5062111801243
2016,NY-602,"Newburgh, Middletown/Orange County CoC",343,33,310,894.0,1028.2857142857142
2016,NY-603,"Nassau, Suffolk Counties CoC",3960,174,3786,1088.0,1026.2486956521739
2016,NY-604,"Yonkers, Mount Vernon/Westchester County CoC",1750,131,1619,1122.0,1243.6739130434783
2016,NY-606,Rockland County CoC,141,16,125,1423.0,1134.2
2016,NY-608,Kingston/Ulster County CoC,328,34,294,752.0,773.3
2016,OH-500,Cincinnati/Hamilton County CoC,1116,24,1092,546.0,496.0
2016,OH-501,Toledo/Lucas County CoC,599,31,568,464.0,532.75
2016,OH-502,Cleveland/Cuyahoga County CoC,1697,193,1504,535.0,533.0
2016,OH-503,Columbus/Franklin County CoC,1724,160,1564,566.0,531.8333333333334
2016,OH-504,Youngstown/Mahoning County CoC,346,43,303,483.0,467.5
2016,OH-505,"Dayton, Kettering/Montgomery County CoC",751,56,695,540.0,487.2857142857143
2016,OH-506,"Akron, Barberton/Summit County CoC",679,45,634,543.0,496.3333333333333
2016,OH-507,Ohio Balance of State CoC,3032,182,2850,499.0945948749871,495.02986564996365
2016,OH-508,"Canton, Massillon, Alliance/Stark County CoC",460,44,416,447.0,493.3333333333333
2016,OK-500,North Central Oklahoma CoC,129,12,117,506.0,449.16666666666663
2016,OK-501,Tulsa City & County CoC,1043,118,925,523.0,456.88888888888886
2016,OK-502,Oklahoma City CoC,1511,320,1191,576.0,505.66666666666663
2016,OK-503,Oklahoma Balance of State CoC,295,71,224,487.2902421652422,480.7058404558405
2016,OK-504,Norman/Cleveland County CoC,138,60,78,576.0,537.0
2016,OK-505,Northeast Oklahoma CoC,368,35,333,507.31972789115645,492.8639455782313
2016,OK-506,Southwest Oklahoma Regional CoC,187,15,172,499.5666666666667,476.96875
2016,OK-507,Southeastern Oklahoma Regional CoC,436,65,371,454.8520833333333,479.7104166666666
2016,OR-500,"Eugene, Springfield/Lane County CoC",1451,574,877,598.0,564.7
2016,OR-501,"Portland, Gresham/Multnomah County CoC",3914,1053,2861,965.0,691.3333333333334
2016,OR-502,"Medford, Ashland/Jackson County CoC",527,184,343,644.0,530.5
2016,OR-503,Central Oregon CoC,602,218,384,594.1333333333333,516.9666666666667
2016,OR-505,Oregon Balance of State CoC,5710,1078,4632,574.7320601851851,579.5292824074073
2016,OR-506,"Hillsboro, Beaverton/Washington County CoC",571,142,429,965.0,688.4166666666666
2016,OR-507,Clackamas County CoC,463,211,252,965.0,655.25
2016,PA-500,Philadelphia CoC,6112,853,5259,830.0,814.0
2016,PA-501,Harrisburg/Dauphin County CoC,433,42,391,633.0,559.3888888888888
2016,PA-502,"Upper Darby, Chester, Haverford/Delaware County CoC",406,26,380,830.0,814.0
2016,PA-503,"Wilkes-Barre, Hazleton/Luzerne County CoC",169,2,167,468.0,545.1666666666667
2016,PA-504,"Lower Merion, Norristown, Abington/Montgomery County CoC",398,17,381,830.0,754.6666666666666
2016,PA-505,Chester County CoC,558,7,551,830.0,739.8333333333334
2016,PA-506,Reading/Berks County CoC,521,19,502,590.0,696.5833333333334
2016,PA-508,Scranton/Lackawanna County CoC,242,13,229,468.0,544.75
2016,PA-509,Eastern Pennsylvania CoC,2599,159,2440,623.3145833333333,658.996875
2016,PA-510,Lancaster City & County CoC,356,6,350,641.0,647.9166666666666
2016,PA-511,"Bristol, Bensalem/Bucks County CoC",530,22,508,830.0,836.5833333333334
2016,PA-512,York City & County CoC,365,14,351,600.0,735.1666666666666
2016,PA-600,"Pittsburgh, McKeesport, Penn Hills/Allegheny County CoC",1156,94,1062,597.0,593.0
2016,PA-601,Western Pennsylvania CoC,986,32,954,537.1805555555555,538.1805555555555
2016,PA-603,Beaver County CoC,131,8,123,597.0,515.9166666666666
2016,PA-605,Erie City & County CoC,377,11,366,592.0,497.0
2016,PR-502,Puerto Rico Balance of Commonwealth CoC,2343,881,1462,398.8529411764706,449.05882352941177
2016,PR-503,South-Southeast Puerto Rico CoC,2075,891,1184,420.6764705882353,441.3529411764706
2016,RI-500,Rhode Island Statewide CoC,1160,144,1016,702.8000000000001,892.9609523809524
2016,SC-500,Charleston/Low Country CoC,550,142,408,628.1309523809524,550.9970238095237
2016,SC-501,"Greenville, Anderson, Spartanburg/Upstate CoC",1829,304,1525,517.52,528.95
2016,SC-502,Columbia/Midlands CoC,1350,313,1037,482.8775510204082,592.1122448979592
2016,SC-503,"Myrtle Beach, Sumter City & County CoC",1322,229,1093,558.1846590909091,645.75
2016,SD-500,South Dakota Statewide CoC,1072,44,1028,461.55200156985876,457.47426085818944
2016,TN-500,Chattanooga/Southeast Tennessee CoC,527,91,436,474.7777777777777,476.55555555555554
2016,TN-501,Memphis/Shelby County CoC,1669,106,1563,641.0,599.8333333333334
2016,TN-502,Knoxville/Knox County CoC,748,134,614,529.0,474.92857142857144
2016,TN-503,Central Tennessee CoC,296,32,264,539.825,519.5464285714286
2016,TN-504,Nashville-Davidson County CoC,2365,978,1387,700.0,654.0
2016,TN-506,Upper Cumberland CoC,249,30,219,539.9891156462585,539.1673469387755
2016,TN-507,Jackson/West Tennessee CoC,1541,164,1377,504.35238095238094,493.3107142857143
2016,TN-509,Appalachian Regional CoC,448,117,331,450.0357142857143,497.75
2016,TN-510,Murfreesboro/Rutherford County CoC,306,37,269,700.0,601.5833333333334
2016,TN-512,"Morristown/Blount, Sevier, Campbell, Cocke Counties CoC",630,93,537,468.45204081632653,468.42976190476196
2016,TX-500,San Antonio/Bexar County CoC,2781,521,2260,636.0,557.0
2016,TX-503,Austin/Travis County CoC,2138,742,1396,791.0,661.6666666666666
2016,TX-600,"Dallas City & County, Irving CoC",3810,597,3213,667.0,620.7777777777778
2016,TX-601,"Fort Worth, Arlington/Tarrant County CoC",1938,189,1749,665.0,612.5500000000001
2016,TX-603,El Paso City & County CoC,1100,105,995,598.0,443.75
2016,TX-604,Waco/McLennan County CoC,267,35,232,510.5333333333333,565.1
2016,TX-607,Texas Balance of State CoC,6048,853,5195,568.345229117288,560.356167851756
2016,TX-624,"Wichita Falls/Wise, Palo Pinto, Wichita, Archer Counties CoC",256,36,220,575.7309523809524,503.54761904761904
2016,TX-700,"Houston, Pasadena, Conroe/Harris, Ft. Bend, Montgomery, Counties CoC",4031,516,3515,734.0,550.3846153846154
2016,TX-701,"Bryan, College Station/Brazos Valley CoC",161,10,151,544.8410256410257,562.1333333333333
2016,UT-500,Salt Lake City & County CoC,1891,164,1727,634.0,588.3333333333334
2016,UT-503,Utah Balance of State CoC,738,17,721,516.5875,569.4965277777778
2016,UT-504,Provo/Mountainland CoC,178,9,169,704.9333333333334,581.5666666666667
2016,VA-500,"Richmond/Henrico, Chesterfield, Hanover Counties CoC",762,94,668,847.0,780.2708333333334
2016,VA-501,"Norfolk, Chesapeake, Suffolk/Isle of Wight, Southampton Counties CoC",723,34,689,850.0714285714286,779.2380952380952
2016,VA-502,"Roanoke City & County, Salem CoC",308,73,235,568.4166666666666,546.125
2016,VA-503,Virginia Beach CoC,389,27,362,947.0,894.0
2016,VA-504,Charlottesville CoC,157,33,124,762.4242424242425,673.1590909090909
2016,VA-505,"Newport News, Hampton/Virginia Peninsula CoC",464,53,411,947.0,856.2777777777778
2016,VA-508,Lynchburg CoC,174,17,157,618.0,588.3333333333334
2016,VA-513,"Harrisburg, Winchester/Western Virginia CoC",268,69,199,672.5634920634922,680.1428571428572
2016,VA-514,"Fredericksburg/Spotsylvania, Stafford Counties CoC",209,13,196,846.8,753.9
2016,VA-521,Virginia Balance of State CoC,654,58,596,600.4232120310245,613.9806172993673
2016,VA-603,Alexandria CoC,224,47,177,1307.0,1260.0
2016,VT-500,Vermont Balance of State CoC,785,59,726,769.8892857142857,705.2486263736264
2016,VT-501,Burlington/Chittenden County CoC,332,68,264,802.0,664.7333333333333
2016,WA-500,Seattle/King County CoC,10730,814,9916,1136.0,756.3333333333334
2016,WA-501,Washington Balance of State CoC,5706,860,4846,581.5972222222222,719.5868055555555
2016,WA-502,Spokane City & County CoC,981,188,793,515.0,505.875
2016,WA-503,"Tacoma, Lakewood/Pierce County CoC",1762,388,1374,742.0,823.0
2016,WA-504,Everett/Snohomish County CoC,960,254,706,1136.0,819.75
2016,WI-500,Wisconsin Balance of State CoC,3445,187,3258,545.3916262879421,581.8232748538011
2016,WI-501,Milwaukee City & County CoC,1415,58,1357,596.0,562.25
2016,WI-502,Racine City & County CoC,196,2,194,687.0,604.0833333333334
2016,WI-503,Madison/Dane County CoC,629,116,513,695.0,510.0
2016,WV-500,"Wheeling, Weirton Area CoC",91,28,63,476.25,540.0833333333334
2016,WV-501,"Huntington/Cabell, Wayne Counties CoC",228,13,215,424.0,477.2291666666667
2016,WV-503,"Charleston/Kanawha, Putnam, Boone, Clay Counties CoC",320,40,280,570.4705882352941,454.7941176470588
2016,WV-508,West Virginia Balance of State CoC,748,84,664,485.4998901098901,524.1580586080586
2016,WY-500,Wyoming Statewide CoC,857,91,766,597.8263528138528,562.4721320346321
2015,AK-500,Anchorage CoC,1208,127,1081,866.0,739.0
2015,AK-501,Alaska Balance of State CoC,748,95,653,694.0,823.0
2015,AL-500,"Birmingham/Jefferson, St. Clair, Shelby Counties CoC",1153,241,912,595.0,507.8888888888889
2015,AL-501,Mobile City & County/Baldwin County CoC,578,107,471,610.6,561.05
2015,AL-502,Florence/Northwest Alabama CoC,245,28,217,494.0,446.4666666666666
2015,AL-503,Huntsville/North Alabama CoC,420,119,301,541.7083333333334,437.5416666666667
2015,AL-504,Montgomery City & County CoC,441,24,417,637.0,442.75
2015,AL-506,Tuscaloosa City & County CoC,339,50,289,481.0,533.3333333333334
2015,AL-507,Alabama Balance of State CoC,638,36,602,509.1025829562594,548.8186274509803
2015,AR-500,Little Rock/Central Arkansas CoC,830,220,610,544.7,464.6166666666667
2015,AR-501,Fayetteville/Northwest Arkansas CoC,665,202,463,507.5333333333333,434.37777777777774
2015,AR-503,Arkansas  Balance of State  CoC,814,109,705,474.6929411764707,499.6057843137255
2015,AR-505,Southeast Arkansas CoC,72,2,70,445.3490476190476,520.7914285714285
2015,AZ-500,Arizona Balance of State CoC,2402,542,1860,541.165,595.4916666666667
2015,AZ-501,Tucson/Pima County CoC,1863,344,1519,522.0,590.3
2015,AZ-502,"Phoenix, Mesa/Maricopa County CoC",5631,480,5151,620.0,541.8
2015,CA-500,San Jose/Santa Clara City & County CoC,6556,2207,4349,1317.0,898.6666666666666
2015,CA-501,San Francisco CoC,6775,1629,5146,1378.0,1210.0
2015,CA-502,"Oakland, Berkeley/Alameda County CoC",4040,750,3290,1120.0,1025.8333333333333
2015,CA-503,Sacramento City & County CoC,2659,502,2157,726.0,751.875
2015,CA-504,"Santa Rosa, Petaluma/Sonoma County CoC",3097,702,2395,958.0,919.8333333333334
2015,CA-505,Richmond/Contra Costa County CoC,2031,621,1410,1120.0,961.5714285714286
2015,CA-506,"Salinas/Monterey, San Benito Counties CoC",2959,598,2361,881.5,819.0
2015,CA-507,Marin County CoC,1318,281,1037,1378.0,1019.0
2015,CA-508,Watsonville/Santa Cruz City & County CoC,1964,582,1382,1146.0,1114.8333333333333
2015,CA-509,Mendocino County CoC,947,112,835,868.0,697.5
2015,CA-510,"Turlock, Modesto/Stanislaus County CoC",1408,59,1349,617.0,828.2
2015,CA-511,Stockton/San Joaquin County CoC,1708,293,1415,643.0,853.1
2015,CA-512,Daly/San Mateo County CoC,1483,319,1164,1378.0,1165.25
2015,CA-513,"Visalia/Kings, Tulare Counties CoC",862,349,513,567.4,790.8
2015,CA-514,Fresno City & County/Madera County CoC,1722,368,1354,687.4666666666667,707.4666666666667
2015,CA-515,"Roseville, Rocklin/Placer County CoC",796,334,462,726.0,665.1666666666666
2015,CA-516,"Redding/Shasta, Siskiyou, Lassen, Plumas, Del Norte, Modoc, Sierra Counties CoC",591,298,293,639.3888888888889,622.7962962962963
2015,CA-517,Napa City & County CoC,293,132,161,975.0,790.25
2015,CA-518,Vallejo/Solano County CoC,1082,227,855,814.0,956.1666666666666
2015,CA-519,"Chico, Paradise/Butte County CoC",571,257,314,562.0,583.125
2015,CA-520,Merced City & County CoC,898,221,677,530.0,756.4
2015,CA-521,"Davis, Woodland/Yolo County CoC",498,87,411,813.0,712.8333333333334
2015,CA-522,Humboldt County CoC,1180,392,788,677.0,691.6666666666666
2015,CA-523,"Colusa, Glenn, Trinity Counties CoC",136,35,101,618.875,654.5
2015,CA-524,Yuba City & County/Sutter County CoC,716,198,518,585.0,704.0
2015,CA-525,El Dorado County CoC,269,104,165,726.0,719.0
2015,CA-526,"Amador, Calaveras, Mariposa, Tuolumne Counties CoC",430,101,329,649.0476190476192,674.1428571428571
2015,CA-600,Los Angeles City & County CoC,41174,14173,27001,993.0,889.25
2015,CA-601,San Diego City and County CoC,8742,1689,7053,1049.0,818.6666666666666
2015,CA-602,"Santa Ana, Anaheim/Orange County CoC",4452,580,3872,1194.0,882.0
2015,CA-603,Santa Maria/Santa Barbara County CoC,1729,374,1355,1117.0,838.3333333333334
2015,CA-604,Bakersfield/Kern County CoC,954,167,787,673.0,885.2142857142857
2015,CA-608,Riverside City & County CoC,2372,532,1840,788.0,795.0
2015,CA-609,San Bernardino City & County CoC,2149,564,1585,788.0,793.0
2015,CA-611,"Oxnard, San Buenaventura/Ventura County CoC",1417,523,894,1042.0,938.3333333333334
2015,CA-613,Imperial County CoC,554,179,375,497.0,781.5
2015,CA-614,San Luis Obispo County CoC,1515,415,1100,934.0,839.5
2015,CO-500,Colorado Balance of State CoC,3545,744,2801,567.5188267288268,510.5587995337995
2015,CO-503,Metropolitan Denver CoC,5335,842,4493,767.4615384615385,558.0384615384615
2015,CO-504,Colorado Springs/El Paso County CoC,1073,291,782,575.0,601.3
2015,CT-503,"Bridgeport, Stamford, Norwalk, Danbury/Fairfield County CoC",913,127,786,1142.0434782608695,1042.6
2015,CT-505,Connecticut Balance of State CoC,3134,456,2678,761.2785714285714,834.6491718426503
2015,DE-500,Delaware Statewide CoC,953,80,873,786.0,754.7261904761906
2015,FL-500,"Sarasota, Bradenton/Manatee, Sarasota Counties CoC",1198,219,979,717.0,611.8333333333334
2015,FL-501,Tampa/Hillsborough County CoC,1931,315,1616,650.0,658.8
2015,FL-502,"St. Petersburg, Clearwater, Largo/Pinellas County CoC",3387,633,2754,650.0,643.0
2015,FL-503,"Lakeland, Winterhaven/Polk County CoC",464,100,364,687.0,668.9166666666666
2015,FL-504,"Deltona, Daytona Beach/Volusia, Flagler Counties CoC",1325,301,1024,620.25,631.5
2015,FL-505,"Fort Walton Beach/Okaloosa, Walton Counties CoC",683,305,378,725.0,538.0
2015,FL-506,Tallahassee/Leon County CoC,863,134,729,639.1203703703703,544.8055555555555
2015,FL-507,"Orlando/Orange, Osceola, Seminole Counties CoC",2112,212,1900,746.0,627.0
2015,FL-508,"Gainesville/Alachua, Putnam Counties CoC",870,395,475,585.4444444444445,611.0416666666666
2015,FL-509,"Fort Pierce/St. Lucie, Indian River, Martin Counties CoC",2412,131,2281,638.25,666.9
2015,FL-510,"Jacksonville-Duval, Clay Counties CoC",1853,353,1500,671.0,591.6666666666666
2015,FL-511,"Pensacola/Escambia, Santa Rosa Counties CoC",1014,219,795,654.0,607.6666666666666
2015,FL-512,St. Johns County CoC,1161,121,1040,671.0,645.6666666666666
2015,FL-513,"Palm Bay, Melbourne/Brevard County CoC",1072,159,913,573.0,642.0
2015,FL-514,Ocala/Marion County CoC,787,66,721,542.0,612.7777777777777
2015,FL-515,"Panama City/Bay, Jackson Counties CoC",317,25,292,522.625,585.0833333333334
2015,FL-517,"Hendry, Hardee, Highlands Counties CoC",1218,227,991,581.2749999999999,701.1
2015,FL-518,"Columbia, Hamilton, Lafayette, Suwannee Counties CoC",1115,209,906,515.1,616.9
2015,FL-519,Pasco County CoC,1019,433,586,650.0,643.5
2015,FL-520,"Citrus, Hernando, Lake, Sumter Counties CoC",731,38,693,700.0,618.6666666666666
2015,FL-600,Miami-Dade County CoC,4152,526,3626,801.0,883.6666666666666
2015,FL-601,Ft Lauderdale/Broward County CoC,2615,444,2171,764.0,729.0
2015,FL-602,Punta Gorda/Charlotte County CoC,562,156,406,542.0,683.75
2015,FL-603,"Ft Myers, Cape Coral/Lee County CoC",614,180,434,753.0,637.1666666666666
2015,FL-604,Monroe County CoC,615,148,467,1309.0,783.0
2015,FL-605,West Palm Beach/Palm Beach County CoC,1421,452,969,752.0,698.4444444444445
2015,FL-606,Naples/Collier County CoC,389,39,350,746.0,808.4
2015,GA-500,Atlanta CoC,4317,781,3536,755.0,738.0
2015,GA-501,Georgia Balance of State CoC,5797,931,4866,592.5912725874664,587.348615916955
2015,GA-503,Athens-Clarke County CoC,226,32,194,591.0,612.2
2015,GA-504,Augusta-Richmond County CoC,407,34,373,573.0,574.5
2015,GA-505,Columbus-Muscogee CoC,371,59,312,588.0,560.3333333333333
2015,GA-506,Marietta/Cobb County CoC,415,49,366,755.0,738.0
2015,GA-507,Savannah/Chatham County CoC,1100,121,979,671.0,569.6666666666667
2015,GA-508,DeKalb County CoC,684,83,601,755.0,738.0
2015,IA-500,"Sioux City/Dakota, Woodbury Counties CoC",276,26,250,456.0,407.9
2015,IA-501,Iowa Balance of State CoC,1975,135,1840,442.2034965034964,465.9699189699189
2015,IA-502,Des Moines/Polk County CoC,830,114,716,558.0,513.4285714285714
2015,ID-500,Boise/Ada County CoC,755,94,661,462.0,452.0
2015,ID-501,Idaho Balance of State CoC,1211,151,1060,488.84861111111115,510.7298611111111
2015,IL-500,McHenry County CoC,177,6,171,812.0,702.1
2015,IL-501,"Rockford/DeKalb, Winnebago, Boone Counties CoC",428,31,397,564.6,641.7
2015,IL-502,"Waukegan, North Chicago/Lake County CoC",386,46,340,812.0,686.3333333333334
2015,IL-503,"Champaign, Urbana, Rantoul/Champaign County CoC",163,5,158,563.0,544.375
2015,IL-506,"Joliet, Bolingbrook/Will County CoC",340,49,291,746.404761904762,629.9047619047618
2015,IL-507,"Peoria, Pekin/Fulton, Tazewell, Peoria, Woodford Counties CoC",451,76,375,470.6666666666667,474.5555555555556
2015,IL-511,Cook County CoC,895,106,789,812.0,696.7142857142857
2015,IL-512,Bloomington/Central Illinois CoC,619,63,556,511.228835978836,510.32539682539687
2015,IL-513,Springfield/Sangamon County CoC,326,30,296,496.0,459.0833333333333
2015,IL-514,DuPage County CoC,672,54,618,812.0,752.0
2015,IL-515,South Central Illinois CoC,122,12,110,481.9333333333333,499.0111111111112
2015,IL-516,Decatur/Macon County CoC,238,70,168,432.0,483.88888888888886
2015,IL-517,"Aurora, Elgin/Kane County CoC",388,87,301,812.0,712.4
2015,IL-518,"Rock Island, Moline/Northwestern Illinois CoC",254,31,223,452.9455782312925,494.35884353741494
2015,IL-519,West Central Illinois CoC,100,8,92,437.3020408163265,463.8843537414965
2015,IL-520,Southern Illinois CoC,346,43,303,435.4902777777778,463.43055555555554
2015,IN-502,Indiana Balance of State CoC,4197,488,3709,498.6532026143791,545.4460224089636
2015,IN-503,Indianapolis CoC,1666,215,1451,549.0,540.0
2015,KS-502,Wichita/Sedgwick County CoC,561,94,467,471.0,464.5
2015,KS-503,Topeka/Shawnee County CoC,405,82,323,443.0,492.3333333333333
2015,KS-507,Kansas Balance of State CoC,1208,152,1056,463.2741425241425,477.2643606393606
2015,KY-500,Kentucky Balance of State CoC,2119,84,2035,468.1917800453515,447.665873015873
2015,KY-501,Louisville-Jefferson County CoC,1161,145,1016,540.0,513.6
2015,KY-502,Lexington-Fayette County CoC,1258,228,1030,543.0,500.5
2015,LA-500,Lafayette/Acadiana CoC,493,68,425,486.448717948718,523.5769230769231
2015,LA-502,"Shreveport, Bossier/Northwest Louisiana CoC",390,116,274,556.3472222222222,506.7916666666667
2015,LA-503,New Orleans/Jefferson Parish CoC,1703,423,1280,691.0,674.6666666666667
2015,LA-505,Monroe/Northeast Louisiana CoC,191,19,172,499.34285714285716,507.3714285714286
2015,LA-506,Slidell/Southeast Louisiana CoC,243,36,207,615.4270833333334,594.5
2015,LA-507,Alexandria/Central Louisiana CoC,154,17,137,505.87103174603175,498.9464285714286
2015,LA-509,Louisiana Balance of State CoC,907,94,813,596.0757211538462,571.8762019230769
2015,MA-500,Boston CoC,6492,957,5535,1163.0,1053.1752645502647
2015,MA-503,Cape Cod Islands CoC,362,78,284,865.75,895.9583333333334
2015,MA-504,Springfield/Hampden County CoC,3002,293,2709,652.0,675.0805555555556
2015,MA-506,Worcester City & County CoC,1682,61,1621,692.1999999999999,744.7983498196633
2015,MA-507,"Pittsfield/Berkshire, Franklin, Hampshire Counties CoC",781,107,674,691.5,717.8166666666667
2015,MA-511,"Quincy, Brockton, Weymouth, Plymouth City and County CoC",1803,256,1547,1033.3703703703704,967.2142857142858
2015,MA-516,Massachusetts Balance of State CoC,5021,577,4444,1121.2662138929647,845.0989517166937
2015,MA-519,"Attleboro, Taunton/Bristol County CoC",240,21,219,782.45,926.3184523809524
2015,MD-501,Baltimore CoC,2796,556,2240,833.0,847.0
2015,MD-503,Annapolis/Anne Arundel County CoC,335,71,264,833.0,836.6666666666666
2015,MD-505,Baltimore County CoC,745,213,532,833.0,775.5
2015,MD-506,Carroll County CoC,140,32,108,833.0,685.3333333333334
2015,MD-511,Mid-Shore Regional CoC,158,22,136,722.2666666666667,742.5666666666667
2015,MD-513,"Wicomico, Somerset, Worcester Counties CoC",326,51,275,516.6666666666666,720.0
2015,MD-514,Maryland Balance of State CoC,1999,662,1337,757.8333333333335,638.6931818181819
2015,ME-500,Maine Statewide CoC,2372,217,2155,645.2206896551725,728.227027027027
2015,MI-500,Michigan Balance of State CoC,1824,62,1762,501.0973086124402,545.6253887559808
2015,MI-502,"Dearborn, Dearborn Heights, Westland/Wayne County CoC",333,7,326,548.0,586.25
2015,MI-503,"St. Clair Shores, Warren/Macomb County CoC",450,39,411,548.0,545.0
2015,MI-504,"Pontiac, Royal Oak/Oakland County CoC",485,51,434,548.0,561.3333333333334
2015,MI-505,Flint/Genesee County CoC,488,95,393,451.0,505.0833333333333
2015,MI-506,"Grand Rapids, Wyoming/Kent County CoC",912,50,862,549.0,539.4666666666667
2015,MI-507,"Portage, Kalamazoo City & County CoC",568,22,546,498.0,486.5833333333333
2015,MI-508,"Lansing, East Lansing/Ingham County CoC",418,78,340,525.0,523.625
2015,MI-509,Washtenaw County CoC,372,89,283,728.0,556.0
2015,MI-510,Saginaw City & County CoC,308,24,284,443.0,455.0
2015,MI-511,Lenawee County CoC,128,19,109,653.0,512.3333333333334
2015,MI-512,"Grand Traverse, Antrim, Leelanau Counties CoC",302,49,253,567.9375,467.63541666666663
2015,MI-514,Battle Creek/Calhoun County CoC,285,43,242,439.0,510.75
2015,MI-515,Monroe City & County CoC,185,6,179,503.0,571.75
2015,MI-516,"Norton Shores, Muskegon City & County CoC",179,5,174,452.0,571.1
2015,MI-517,Jackson City & County CoC,159,6,153,513.0,539.8571428571429
2015,MI-518,Livingston County CoC,103,2,101,561.0,531.5
2015,MI-519,Holland/Ottawa County CoC,285,23,262,622.0,537.8
2015,MI-523,Eaton County CoC,135,2,133,525.0,505.75
2015,MN-500,Minneapolis/Hennepin County CoC,3215,637,2578,683.0,648.0
2015,MN-501,Saint Paul/Ramsey County CoC,1398,281,1117,683.0,648.0
2015,MN-502,Rochester/Southeast Minnesota CoC,451,69,382,471.85470085470087,491.6367521367521
2015,MN-503,"Dakota, Anoka, Washington, Scott, Carver Counties",608,64,544,683.0,596.5277777777778
2015,MN-504,Northeast Minnesota CoC,68,18,50,510.76761904761906,471.6190476190476
2015,MN-505,St. Cloud/Central Minnesota CoC,696,12,684,601.4183673469388,526.2925170068028
2015,MN-506,Northwest Minnesota CoC,254,60,194,471.3666666666667,477.69166666666666
2015,MN-508,Moorhead/West Central Minnesota CoC,242,40,202,444.4866666666667,466.47333333333336
2015,MN-509,Duluth/St.Louis County CoC,490,205,285,518.0,480.0
2015,MN-511,Southwest Minnesota CoC,124,10,114,470.3948717948718,515.6757834757835
2015,MO-500,St. Louis County CoC,438,30,408,567.0,567.0
2015,MO-501,St.Louis City CoC,1312,110,1202,567.0,567.0
2015,MO-503,"St. Charles City & County, Lincoln, Warren Counties CoC",803,58,745,567.0,534.5
2015,MO-600,"Springfield/Greene, Christian, Webster Counties CoC",584,161,423,469.0,424.1666666666667
2015,MO-602,"Joplin/Jasper, Newton Counties CoC",258,45,213,492.0,446.9444444444444
2015,MO-603,"St. Joseph/Andrew, Buchanan, DeKalb Counties CoC",164,65,99,501.0,489.8333333333333
2015,MO-606,Missouri Balance of State CoC,1477,168,1309,451.6126489811611,484.8814837699786
2015,MS-500,"Jackson/Rankin, Madison Counties CoC",762,104,658,549.9473684210527,468.719298245614
2015,MS-501,Mississippi Balance of State CoC,809,85,724,469.6730528243686,522.2619529593214
2015,MS-503,Gulf Port/Gulf Coast Regional CoC,412,54,358,621.9047619047619,629.297619047619
2015,MT-500,Montana Statewide CoC,1709,166,1543,510.8424242424243,527.2287878787879
2015,NC-500,Winston-Salem/Forsyth County CoC,571,98,473,577.0,549.75
2015,NC-501,Asheville/Buncombe County CoC,562,74,488,547.0,486.16666666666663
2015,NC-502,Durham City & County CoC,813,59,754,640.0,617.4444444444445
2015,NC-503,North Carolina Balance of State CoC,3021,360,2661,546.6877696078432,544.7695519676402
2015,NC-504,"Greensboro, High Point CoC",665,78,587,556.0,561.0
2015,NC-505,Charlotte/Mecklenberg CoC,2001,280,1721,681.0,599.5
2015,NC-506,"Wilmington/Brunswick, New Hanover, Pender Counties CoC",390,80,310,607.3333333333333,597.0
2015,NC-507,Raleigh/Wake County CoC,904,90,814,700.0,614.3333333333333
2015,NC-509,"Gastonia/Cleveland, Gaston, Lincoln Counties CoC",281,64,217,553.0,573.4
2015,NC-511,Fayetteville/Cumberland County CoC,593,131,462,650.0,503.0
2015,NC-513,Chapel Hill/Orange County CoC,129,25,104,640.0,579.125
2015,NC-516,Northwest North Carolina CoC,755,25,730,493.0192307692308,474.8873626373626
2015,ND-500,North Dakota Statewide CoC,1305,138,1167,483.50710227272725,449.578125
2015,NE-500,Nebraska Balance of State CoC,549,13,536,434.4173382173382,459.45882173382176
2015,NE-501,"Omaha, Council Bluffs CoC",1481,262,1219,509.0,462.0
2015,NE-502,Lincoln CoC,714,47,667,447.0,433.0
2015,NH-500,New Hampshire Balance of State CoC,718,212,506,771.0413288288288,738.6110098590076
2015,NH-502,Nashua/Hillsborough County CoC,327,49,278,775.4193548387096,805.8742242242242
2015,NJ-500,Atlantic City & County CoC,548,113,435,873.0,849.4166666666666
2015,NJ-501,Bergen County CoC,340,28,312,1153.0,1164.3333333333333
2015,NJ-502,Burlington County CoC,1347,200,1147,814.0,881.4285714285714
2015,NJ-503,"Camden City & County/Gloucester, Cape May, Cumberland Counties CoC",1089,103,986,805.7083333333334,789.5833333333334
2015,NJ-504,Newark/Essex County CoC,1610,152,1458,1103.0,1125.0
2015,NJ-506,"Jersey City, Bayonne/Hudson County CoC",917,177,740,1091.0,1166.25
2015,NJ-507,New Brunswick/Middlesex County CoC,604,86,518,1020.0,1065.8
2015,NJ-508,Monmouth County CoC,456,99,357,1000.0,1006.2
2015,NJ-509,Morris County CoC,384,49,335,1103.0,1064.5333333333333
2015,NJ-510,Lakewood Township/Ocean County CoC,605,172,433,1000.0,876.6666666666666
2015,NJ-511,Paterson/Passaic County CoC,459,43,416,1153.0,1117.0
2015,NJ-513,Somerset County CoC,342,34,308,1020.0,1029.6
2015,NJ-514,Trenton/Mercer County CoC,600,75,525,992.0,929.3333333333334
2015,NJ-515,Elizabeth/Union County CoC,504,36,468,1103.0,1092.5
2015,NJ-516,"Warren, Sussex, Hunterdon Counties CoC",255,41,214,998.1666666666666,957.25
2015,NM-501,New Mexico Balance of State CoC,1342,456,886,487.98106060606057,499.52119408369407
2015,NV-500,Las Vegas/Clark County CoC,7509,458,7051,669.0,651.875
2015,NV-501,"Reno, Sparks/Washoe County CoC",907,90,817,585.0,619.6666666666667
2015,NV-502,Nevada Balance of State CoC,327,46,281,504.7971781305115,611.5833333333334
2015,NY-500,"Rochester, Irondequoit, Greece/Monroe County CoC",762,49,713,623.0,578.8333333333334
2015,NY-501,"Elmira/Steuben, Allegany, Livingston, Chemung, Schuyler Counties CoC",648,92,556,550.1666666666667,554.325
2015,NY-503,Albany City & County CoC,597,87,510,733.0,704.1
2015,NY-505,"Syracuse, Auburn/Onondaga, Oswego, Cayuga Counties CoC",922,86,836,583.6,654.2333333333333
2015,NY-507,Schenectady City & County CoC,349,44,305,733.0,689.8333333333334
2015,NY-508,"Buffalo, Niagara Falls/Erie, Niagara, Orleans, Genesee, Wyoming Counties CoC",919,85,834,548.7083333333333,543.8333333333334
2015,NY-510,Ithaca/Tompkins County CoC,88,9,79,852.0,544.875
2015,NY-511,"Binghamton, Union Town/Broome, Otsego, Chenango, Delaware, Cortland, Tioga Count",302,8,294,604.5,639.34375
2015,NY-512,Troy/Rensselaer County CoC,189,46,143,733.0,661.45
2015,NY-513,"Wayne, Ontario, Seneca, Yates Counties CoC",187,38,149,572.675,629.8
2015,NY-514,"Jamestown, Dunkirk/Chautauqua County CoC",29,23,6,541.0,515.25
2015,NY-518,"Utica, Rome/Oneida, Madison Counties CoC",140,41,99,586.3541666666666,597.5625
2015,NY-519,"Columbia, Greene Counties CoC",97,24,73,742.5,712.25
2015,NY-520,"Franklin, Essex Counties CoC",28,3,25,586.7,686.5
2015,NY-522,"Jefferson, Lewis, St. Lawrence Counties CoC",86,8,78,600.5333333333333,596.8666666666667
2015,NY-523,"Glens Falls, Saratoga Springs/Saratoga, Washington, Warren, Hamilton Counties Co",282,36,246,631.2857142857143,637.1071428571429
2015,NY-600,New York City CoC,75323,5830,69493,1323.0,1072.857142857143
2015,NY-601,Poughkeepsie/Dutchess County CoC,375,31,344,889.0,894.2872670807454
2015,NY-602,"Newburgh, Middletown/Orange County CoC",495,119,376,889.0,1036.7857142857142
2015,NY-603,"Nassau, Suffolk Counties CoC",3861,200,3661,1198.0,986.5592638601335
2015,NY-604,"Yonkers, Mount Vernon/Westchester County CoC",1797,175,1622,1153.0,1214.2101449275362
2015,NY-606,Rockland County CoC,117,1,116,1323.0,1128.6
2015,NY-608,Kingston/Ulster County CoC,343,49,294,732.0,788.1
2015,OH-500,Cincinnati/Hamilton County CoC,1063,175,888,496.0,472.0
2015,OH-501,Toledo/Lucas County CoC,564,42,522,433.0,524.0
2015,OH-502,Cleveland/Cuyahoga County CoC,1943,217,1726,536.0,518.2
2015,OH-503,Columbus/Franklin County CoC,1721,207,1514,532.0,527.3333333333334
2015,OH-504,Youngstown/Mahoning County CoC,368,86,282,499.0,455.9444444444444
2015,OH-505,"Dayton, Kettering/Montgomery County CoC",971,27,944,527.0,479.42857142857144
2015,OH-506,"Akron, Barberton/Summit County CoC",760,157,603,531.0,485.0833333333333
2015,OH-507,Ohio Balance of State CoC,3320,297,3023,469.55102189023756,481.2588053740014
2015,OH-508,"Canton, Massillon, Alliance/Stark County CoC",472,67,405,439.0,473.4444444444444
2015,OK-500,North Central Oklahoma CoC,194,33,161,496.7666666666666,437.66666666666663
2015,OK-501,Tulsa City & County CoC,956,89,867,526.0,437.0
2015,OK-502,Oklahoma City CoC,1300,214,1086,537.0,494.33333333333337
2015,OK-503,Oklahoma Balance of State CoC,237,50,187,462.156339031339,477.60624406457737
2015,OK-504,Norman/Cleveland County CoC,133,30,103,537.0,518.0
2015,OK-505,Northeast Oklahoma CoC,343,87,256,468.40816326530614,469.94557823129253
2015,OK-506,Southwest Oklahoma Regional CoC,161,26,135,454.1666666666667,467.58333333333326
2015,OK-507,Southeastern Oklahoma Regional CoC,453,52,401,440.09791666666666,467.78333333333336
2015,OR-500,"Eugene, Springfield/Lane County CoC",1473,697,776,525.0,542.9
2015,OR-501,"Portland, Gresham/Multnomah County CoC",3801,1033,2768,716.0,699.3333333333334
2015,OR-502,"Medford, Ashland/Jackson County CoC",729,234,495,646.0,528.6666666666666
2015,OR-503,Central Oregon CoC,594,222,372,499.4666666666667,515.5
2015,OR-505,Oregon Balance of State CoC,5544,1457,4087,528.3091435185185,570.4332175925925
2015,OR-506,"Hillsboro, Beaverton/Washington County CoC",591,128,463,716.0,671.75
2015,OR-507,Clackamas County CoC,494,240,254,716.0,656.0833333333334
2015,PA-500,Philadelphia CoC,5998,829,5169,814.0,799.0
2015,PA-501,Harrisburg/Dauphin County CoC,402,50,352,647.0,568.0
2015,PA-502,"Upper Darby, Chester, Haverford/Delaware County CoC",436,41,395,814.0,799.0
2015,PA-503,"Wilkes-Barre, Hazleton/Luzerne County CoC",174,0,174,532.0,523.0833333333333
2015,PA-504,"Lower Merion, Norristown, Abington/Montgomery County CoC",429,37,392,814.0,744.8333333333334
2015,PA-505,Chester County CoC,612,0,612,814.0,736.3333333333334
2015,PA-506,Reading/Berks County CoC,561,83,478,561.0,695.0
2015,PA-508,Scranton/Lackawanna County CoC,233,28,205,532.0,517.5
2015,PA-509,Eastern Pennsylvania CoC,2410,164,2246,612.5822916666667,663.0822916666667
2015,PA-510,Lancaster City & County CoC,378,7,371,622.0,632.6666666666666
2015,PA-511,"Bristol, Bensalem/Bucks County CoC",487,38,449,814.0,824.6666666666666
2015,PA-512,York City & County CoC,345,29,316,527.0,749.25
2015,PA-600,"Pittsburgh, McKeesport, Penn Hills/Allegheny County CoC",1424,154,1270,593.0,595.0
2015,PA-601,Western Pennsylvania CoC,1002,91,911,524.5277777777777,525.8541666666666
2015,PA-603,Beaver County CoC,120,9,111,593.0,494.16666666666663
2015,PA-605,Erie City & County CoC,410,30,380,472.0,480.6666666666667
2015,PR-502,Puerto Rico Balance of Commonwealth CoC,2422,893,1529,441.3529411764706,440.94117647058823
2015,PR-503,South-Southeast Puerto Rico CoC,2096,863,1233,449.05882352941177,432.5882352941176
2015,RI-500,Rhode Island Statewide CoC,1111,130,981,726.8000000000001,858.6661904761904
2015,SC-500,Charleston/Low Country CoC,606,117,489,587.9880952380953,544.9434523809523
2015,SC-501,"Greenville, Anderson, Spartanburg/Upstate CoC",1961,407,1554,530.77,546.5888888888888
2015,SC-502,Columbia/Midlands CoC,1468,319,1149,523.1887755102041,593.6635487528345
2015,SC-503,"Myrtle Beach, Sumter City & County CoC",1319,177,1142,544.1136363636364,636.3380681818182
2015,SD-500,South Dakota Statewide CoC,1036,95,941,489.87715855573003,449.0218799058084
2015,TN-500,Chattanooga/Southeast Tennessee CoC,636,126,510,450.44444444444446,460.4404761904762
2015,TN-501,Memphis/Shelby County CoC,1525,92,1433,659.0,553.8333333333334
2015,TN-502,Knoxville/Knox County CoC,783,108,675,525.0,470.6428571428571
2015,TN-503,Central Tennessee CoC,268,54,214,511.5639880952381,521.41875
2015,TN-504,Nashville-Davidson County CoC,2154,661,1493,654.0,653.0
2015,TN-506,Upper Cumberland CoC,362,36,326,504.75374149659865,536.087074829932
2015,TN-507,Jackson/West Tennessee CoC,1563,255,1308,481.4309523809524,481.3357142857143
2015,TN-509,Appalachian Regional CoC,577,130,447,437.6011904761905,470.13690476190476
2015,TN-510,Murfreesboro/Rutherford County CoC,289,39,250,654.0,598.25
2015,TN-512,"Morristown/Blount, Sevier, Campbell, Cocke Counties CoC",966,149,817,439.3867346938776,455.725
2015,TX-500,San Antonio/Bexar County CoC,2891,691,2200,588.0,543.8571428571429
2015,TX-503,Austin/Travis County CoC,1832,494,1338,723.0,652.8333333333334
2015,TX-600,"Dallas City & County, Irving CoC",3141,615,2526,651.0,613.0
2015,TX-601,"Fort Worth, Arlington/Tarrant County CoC",1914,136,1778,629.0,601.0
2015,TX-603,El Paso City & County CoC,1107,132,975,638.0,468.0
2015,TX-604,Waco/McLennan County CoC,255,44,211,492.2,578.8
2015,TX-607,Texas Balance of State CoC,7016,1428,5588,529.5704356101415,552.7039161818573
2015,TX-624,"Wichita Falls/Wise, Palo Pinto, Wichita, Archer Counties CoC",267,80,187,506.7446428571428,498.56428571428575
2015,TX-700,"Houston, Pasadena, Conroe/Harris, Ft. Bend, Montgomery, Counties CoC",4609,600,4009,640.0,537.1153846153846
2015,TX-701,"Bryan, College Station/Brazos Valley CoC",168,15,153,518.5282051282052,558.3538461538461
2015,UT-500,Salt Lake City & County CoC,2176,182,1994,638.0,573.3333333333333
2015,UT-503,Utah Balance of State CoC,646,46,600,513.6652777777778,558.5125
2015,UT-504,Provo/Mountainland CoC,203,5,198,666.1444444444445,571.3333333333334
2015,VA-500,"Richmond/Henrico, Chesterfield, Hanover Counties CoC",818,124,694,797.0,782.8333333333334
2015,VA-501,"Norfolk, Chesapeake, Suffolk/Isle of Wight, Southampton Counties CoC",735,75,660,820.8928571428571,787.3392857142858
2015,VA-502,"Roanoke City & County, Salem CoC",390,80,310,553.5555555555555,497.52777777777777
2015,VA-503,Virginia Beach CoC,419,108,311,894.0,913.0
2015,VA-504,Charlottesville CoC,185,33,152,686.6287878787879,623.3409090909091
2015,VA-505,"Newport News, Hampton/Virginia Peninsula CoC",520,47,473,894.0,865.1666666666666
2015,VA-508,Lynchburg CoC,237,24,213,594.0,565.3333333333334
2015,VA-513,"Harrisburg, Winchester/Western Virginia CoC",242,61,181,649.5952380952381,625.3928571428572
2015,VA-514,"Fredericksburg/Spotsylvania, Stafford Counties CoC",217,51,166,798.2,745.4
2015,VA-521,Virginia Balance of State CoC,773,90,683,624.0763321747697,598.251330960706
2015,VA-603,Alexandria CoC,267,54,213,1260.0,1272.0
2015,VT-500,Vermont Balance of State CoC,1052,65,987,705.3261904761905,713.2751831501831
2015,VT-501,Burlington/Chittenden County CoC,471,101,370,832.0,662.8666666666667
2015,WA-500,Seattle/King County CoC,10122,823,9299,1053.0,672.3333333333334
2015,WA-501,Washington Balance of State CoC,5489,975,4514,525.1909722222222,630.7395833333334
2015,WA-502,Spokane City & County CoC,1034,219,815,494.0,489.5
2015,WA-503,"Tacoma, Lakewood/Pierce County CoC",1283,202,1081,689.0,694.0
2015,WA-504,Everett/Snohomish County CoC,829,160,669,1053.0,700.75
2015,WI-500,Wisconsin Balance of State CoC,3597,238,3359,517.4848538011696,564.7082261208577
2015,WI-501,Milwaukee City & County CoC,1521,104,1417,579.0,555.25
2015,WI-502,Racine City & County CoC,168,10,158,596.0,605.3333333333334
2015,WI-503,Madison/Dane County CoC,771,112,659,677.0,505.7142857142857
2015,WV-500,"Wheeling, Weirton Area CoC",114,38,76,497.1666666666667,535.75
2015,WV-501,"Huntington/Cabell, Wayne Counties CoC",227,40,187,406.0,476.5416666666667
2015,WV-503,"Charleston/Kanawha, Putnam, Boone, Clay Counties CoC",385,58,327,553.0,437.7941176470588
2015,WV-508,West Virginia Balance of State CoC,1109,250,859,519.617962723551,509.915642282554
2015,WY-500,Wyoming Statewide CoC,798,102,696,573.8695346320346,551.2863636363636
2014,AK-500,Anchorage CoC,1023,101,922,823.0,689.0
2014,AK-501,Alaska Balance of State CoC,761,105,656,739.0,780.0
2014,AL-500,"Birmingham/Jefferson, St. Clair, Shelby Counties CoC",1329,331,998,572.0,506.8888888888889
2014,AL-501,Mobile City & County/Baldwin County CoC,598,75,523,636.0,515.0
2014,AL-502,Florence/Northwest Alabama CoC,209,13,196,484.5666666666667,428.2
2014,AL-503,Huntsville/North Alabama CoC,536,107,429,516.25,449.6875
2014,AL-504,Montgomery City & County CoC,490,37,453,577.5,470.875
2014,AL-506,Tuscaloosa City & County CoC,245,80,165,516.0,551.1666666666666
2014,AL-507,Alabama Balance of State CoC,716,50,666,476.5695575666164,535.0737368024134
2014,AR-500,Little Rock/Central Arkansas CoC,1074,350,724,535.9,470.08333333333337
2014,AR-501,Fayetteville/Northwest Arkansas CoC,551,39,512,503.40000000000003,435.24444444444447
2014,AR-503,Arkansas  Balance of State  CoC,1056,50,1006,456.24411764705883,494.5418627450981
2014,AR-505,Southeast Arkansas CoC,70,0,70,430.47523809523807,499.3666666666666
2014,AZ-500,Arizona Balance of State CoC,2398,266,2132,513.4325,574.8166666666667
2014,AZ-501,Tucson/Pima County CoC,2179,290,1889,507.0,566.2
2014,AZ-502,"Phoenix, Mesa/Maricopa County CoC",5918,403,5515,614.0,552.5
2014,CA-500,San Jose/Santa Clara City & County CoC,7567,2535,5032,1190.0,853.3333333333334
2014,CA-501,San Francisco CoC,6408,2321,4087,1307.0,1084.0
2014,CA-502,"Oakland, Berkeley/Alameda County CoC",4272,1094,3178,1113.0,972.8333333333334
2014,CA-503,Sacramento City & County CoC,2449,422,2027,717.0,740.0
2014,CA-504,"Santa Rosa, Petaluma/Sonoma County CoC",4266,1260,3006,871.0,870.6666666666666
2014,CA-505,Richmond/Contra Costa County CoC,2009,775,1234,1113.0,925.5714285714286
2014,CA-506,"Salinas/Monterey, San Benito Counties CoC",2962,1089,1873,847.5,795.6666666666666
2014,CA-507,Marin County CoC,679,62,617,1307.0,970.25
2014,CA-508,Watsonville/Santa Cruz City & County CoC,3529,981,2548,1051.0,1068.0
2014,CA-509,Mendocino County CoC,1404,221,1183,710.0,689.1
2014,CA-510,"Turlock, Modesto/Stanislaus County CoC",1156,146,1010,607.0,803.0666666666667
2014,CA-511,Stockton/San Joaquin County CoC,1588,116,1472,631.0,795.2
2014,CA-512,Daly/San Mateo County CoC,2024,897,1127,1307.0,1091.75
2014,CA-513,"Visalia/Kings, Tulare Counties CoC",763,235,528,592.8,763.8
2014,CA-514,Fresno City & County/Madera County CoC,2592,497,2095,645.2666666666667,698.8666666666667
2014,CA-515,"Roseville, Rocklin/Placer County CoC",762,240,522,717.0,667.75
2014,CA-516,"Redding/Shasta, Siskiyou, Lassen, Plumas, Del Norte, Modoc, Sierra Counties CoC",630,125,505,648.2777777777778,611.5925925925926
2014,CA-517,Napa City & County CoC,285,73,212,914.0,799.0
2014,CA-518,Vallejo/Solano County CoC,1295,350,945,785.0,908.0
2014,CA-519,"Chico, Paradise/Butte County CoC",696,313,383,550.0,568.625
2014,CA-520,Merced City & County CoC,768,364,404,553.0,782.8
2014,CA-521,"Davis, Woodland/Yolo County CoC",442,131,311,815.0,693.3333333333334
2014,CA-522,Humboldt County CoC,932,260,672,716.0,674.3333333333334
2014,CA-523,"Colusa, Glenn, Trinity Counties CoC",567,265,302,667.75,657.1875
2014,CA-524,Yuba City & County/Sutter County CoC,726,53,673,542.0,688.5714285714286
2014,CA-525,El Dorado County CoC,195,73,122,717.0,690.6
2014,CA-526,"Amador, Calaveras, Mariposa, Tuolumne Counties CoC",382,114,268,662.3928571428571,678.5357142857143
2014,CA-600,Los Angeles City & County CoC,34393,8882,25511,977.0,885.25
2014,CA-601,San Diego City and County CoC,8506,1245,7261,1019.0,812.3333333333334
2014,CA-602,"Santa Ana, Anaheim/Orange County CoC",3833,814,3019,1142.0,887.75
2014,CA-603,Santa Maria/Santa Barbara County CoC,1832,618,1214,1178.0,822.0
2014,CA-604,Bakersfield/Kern County CoC,992,178,814,660.0,858.6428571428571
2014,CA-608,Riverside City & County CoC,2945,1093,1852,766.0,801.2
2014,CA-609,San Bernardino City & County CoC,2315,551,1764,766.0,780.2142857142857
2014,CA-611,"Oxnard, San Buenaventura/Ventura County CoC",1428,440,988,989.0,931.3333333333334
2014,CA-613,Imperial County CoC,298,127,171,548.0,788.3333333333334
2014,CA-614,San Luis Obispo County CoC,2366,748,1618,866.0,812.75
2014,CO-500,Colorado Balance of State CoC,2188,493,1695,555.7231041181042,503.22479020979017
2014,CO-503,Metropolitan Denver CoC,6621,801,5820,692.4358974358975,557.8525641025641
2014,CO-504,Colorado Springs/El Paso County CoC,1219,327,892,542.0,593.6
2014,CT-503,"Bridgeport, Stamford, Norwalk, Danbury/Fairfield County CoC",1083,367,716,1104.2608695652175,1049.2
2014,CT-505,Connecticut Balance of State CoC,3367,848,2519,734.9727513227514,814.2146221532091
2014,DE-500,Delaware Statewide CoC,901,91,810,738.2619047619048,761.7023809523808
2014,FL-500,"Sarasota, Bradenton/Manatee, Sarasota Counties CoC",1377,270,1107,710.0,621.5
2014,FL-501,Tampa/Hillsborough County CoC,1944,409,1535,643.0,665.8
2014,FL-502,"St. Petersburg, Clearwater, Largo/Pinellas County CoC",3391,489,2902,643.0,618.0
2014,FL-503,"Lakeland, Winterhaven/Polk County CoC",536,114,422,666.0,670.3055555555555
2014,FL-504,"Deltona, Daytona Beach/Volusia, Flagler Counties CoC",1633,198,1435,621.25,632.6666666666666
2014,FL-505,"Fort Walton Beach/Okaloosa, Walton Counties CoC",1577,436,1141,737.0,521.8333333333334
2014,FL-506,Tallahassee/Leon County CoC,805,220,585,620.5740740740741,518.8611111111112
2014,FL-507,"Orlando/Orange, Osceola, Seminole Counties CoC",2254,125,2129,734.0,633.75
2014,FL-508,"Gainesville/Alachua, Putnam Counties CoC",1256,471,785,580.3611111111111,603.0416666666666
2014,FL-509,"Fort Pierce/St. Lucie, Indian River, Martin Counties CoC",2591,131,2460,654.75,675.8
2014,FL-510,"Jacksonville-Duval, Clay Counties CoC",2049,431,1618,671.0,583.8333333333334
2014,FL-511,"Pensacola/Escambia, Santa Rosa Counties CoC",843,184,659,659.0,594.0
2014,FL-512,St. Johns County CoC,1401,65,1336,671.0,650.0
2014,FL-513,"Palm Bay, Melbourne/Brevard County CoC",1477,120,1357,562.0,644.0
2014,FL-514,Ocala/Marion County CoC,918,95,823,540.0,620.3333333333334
2014,FL-515,"Panama City/Bay, Jackson Counties CoC",268,36,232,523.2916666666666,538.6666666666666
2014,FL-517,"Hendry, Hardee, Highlands Counties CoC",1346,117,1229,609.0016666666667,701.3399999999999
2014,FL-518,"Columbia, Hamilton, Lafayette, Suwannee Counties CoC",1070,621,449,518.1666666666666,608.1333333333333
2014,FL-519,Pasco County CoC,3356,1204,2152,643.0,625.75
2014,FL-520,"Citrus, Hernando, Lake, Sumter Counties CoC",511,10,501,669.5277777777777,615.5
2014,FL-600,Miami-Dade County CoC,4156,732,3424,805.0,930.6666666666666
2014,FL-601,Ft Lauderdale/Broward County CoC,2766,525,2241,762.0,726.5
2014,FL-602,Punta Gorda/Charlotte County CoC,511,156,355,543.0,697.75
2014,FL-603,"Ft Myers, Cape Coral/Lee County CoC",871,281,590,747.0,644.8333333333334
2014,FL-604,Monroe County CoC,678,116,562,1128.0,777.5
2014,FL-605,West Palm Beach/Palm Beach County CoC,1596,396,1200,750.0,703.4444444444445
2014,FL-606,Naples/Collier County CoC,361,37,324,761.0,832.4
2014,GA-500,Atlanta CoC,4797,1341,3456,738.0,719.0
2014,GA-501,Georgia Balance of State CoC,7577,1127,6450,593.6789504036907,586.8218569780853
2014,GA-503,Athens-Clarke County CoC,247,42,205,574.0,626.2
2014,GA-504,Augusta-Richmond County CoC,472,83,389,580.0,573.75
2014,GA-505,Columbus-Muscogee CoC,312,65,247,550.0,532.8333333333333
2014,GA-506,Marietta/Cobb County CoC,523,65,458,738.0,719.0
2014,GA-507,Savannah/Chatham County CoC,1315,150,1165,627.0,618.6666666666667
2014,GA-508,DeKalb County CoC,801,81,720,738.0,719.0
2014,IA-500,"Sioux City/Dakota, Woodbury Counties CoC",297,16,281,444.0,385.06666666666666
2014,IA-501,Iowa Balance of State CoC,1939,112,1827,435.03702963702966,453.41063381063395
2014,IA-502,Des Moines/Polk County CoC,886,116,770,550.0,496.85714285714283
2014,ID-500,Boise/Ada County CoC,753,82,671,450.0,450.8
2014,ID-501,Idaho Balance of State CoC,1351,162,1189,478.99097222222224,522.1576388888889
2014,IL-500,McHenry County CoC,166,10,156,775.0,682.1
2014,IL-501,"Rockford/DeKalb, Winnebago, Boone Counties CoC",506,74,432,567.2,671.7666666666667
2014,IL-502,"Waukegan, North Chicago/Lake County CoC",409,31,378,775.0,654.5833333333334
2014,IL-503,"Champaign, Urbana, Rantoul/Champaign County CoC",205,1,204,603.0,490.625
2014,IL-506,"Joliet, Bolingbrook/Will County CoC",309,16,293,681.6904761904763,615.7619047619047
2014,IL-507,"Peoria, Pekin/Fulton, Tazewell, Peoria, Woodford Counties CoC",405,53,352,488.7777777777778,448.2777777777778
2014,IL-511,Cook County CoC,1182,97,1085,775.0,689.0
2014,IL-512,Bloomington/Central Illinois CoC,669,59,610,514.1150793650794,486.6838624338624
2014,IL-513,Springfield/Sangamon County CoC,269,52,217,503.0,440.7916666666667
2014,IL-514,DuPage County CoC,654,73,581,775.0,772.3333333333334
2014,IL-515,South Central Illinois CoC,118,3,115,487.2654320987654,472.4641975308642
2014,IL-516,Decatur/Macon County CoC,256,65,191,433.0,458.4444444444444
2014,IL-517,"Aurora, Elgin/Kane County CoC",405,95,310,775.0,731.2
2014,IL-518,"Rock Island, Moline/Northwestern Illinois CoC",218,9,209,467.2380952380953,489.7755102040816
2014,IL-519,West Central Illinois CoC,145,6,139,446.19795918367345,449.3659863945578
2014,IL-520,Southern Illinois CoC,325,39,286,445.65208333333334,444.8576388888889
2014,IN-502,Indiana Balance of State CoC,4081,365,3716,492.2570401493931,530.157852474323
2014,IN-503,Indianapolis CoC,1890,231,1659,540.0,530.0
2014,KS-502,Wichita/Sedgwick County CoC,631,107,524,482.0,426.0
2014,KS-503,Topeka/Shawnee County CoC,416,75,341,454.0,498.0
2014,KS-507,Kansas Balance of State CoC,1307,79,1228,464.7567432567432,446.8586829836831
2014,KY-500,Kentucky Balance of State CoC,2229,300,1929,467.2591269841269,431.7377551020408
2014,KY-501,Louisville-Jefferson County CoC,1316,208,1108,519.0,537.8
2014,KY-502,Lexington-Fayette County CoC,1544,219,1325,503.0,488.3333333333333
2014,LA-500,Lafayette/Acadiana CoC,471,43,428,491.525641025641,504.7948717948718
2014,LA-502,"Shreveport, Bossier/Northwest Louisiana CoC",655,128,527,555.625,473.5138888888889
2014,LA-503,New Orleans/Jefferson Parish CoC,1981,472,1509,688.0,664.8333333333333
2014,LA-505,Monroe/Northeast Louisiana CoC,220,26,194,517.1238095238095,443.95
2014,LA-506,Slidell/Southeast Louisiana CoC,262,33,229,619.5104166666667,580.9583333333334
2014,LA-507,Alexandria/Central Louisiana CoC,141,28,113,515.7718253968254,440.3174603174603
2014,LA-509,Louisiana Balance of State CoC,876,46,830,609.4306891025642,551.0040064102564
2014,MA-500,Boston CoC,5987,815,5172,1134.0,1041.8458865027492
2014,MA-503,Cape Cod Islands CoC,381,108,273,840.0,901.587962962963
2014,MA-504,Springfield/Hampden County CoC,2690,520,2170,673.0,680.2548611111112
2014,MA-506,Worcester City & County CoC,1796,62,1734,646.8666666666667,743.3187694708432
2014,MA-507,"Pittsfield/Berkshire, Franklin, Hampshire Counties CoC",753,153,600,680.1927083333334,721.9354166666666
2014,MA-511,"Quincy, Brockton, Weymouth, Plymouth City and County CoC",1643,167,1476,1026.6666666666667,985.0982142857142
2014,MA-516,Massachusetts Balance of State CoC,6129,1248,4881,1093.1790438397582,848.7353141159593
2014,MA-519,"Attleboro, Taunton/Bristol County CoC",222,15,207,765.25,939.3921957671957
2014,MD-501,Baltimore CoC,2567,491,2076,847.0,846.0
2014,MD-503,Annapolis/Anne Arundel County CoC,384,73,311,847.0,852.0
2014,MD-505,Baltimore County CoC,569,119,450,847.0,780.0
2014,MD-506,Carroll County CoC,124,22,102,847.0,680.3333333333334
2014,MD-511,Mid-Shore Regional CoC,111,15,96,749.0333333333334,751.6333333333333
2014,MD-513,"Wicomico, Somerset, Worcester Counties CoC",336,30,306,507.2916666666667,743.4166666666666
2014,MD-514,Maryland Balance of State CoC,2045,711,1334,766.5871212121211,645.6477272727273
2014,ME-500,Maine Statewide CoC,2726,244,2482,627.4482758620691,738.9513513513514
2014,MI-500,Michigan Balance of State CoC,2333,119,2214,496.57499003189804,534.6497906698564
2014,MI-502,"Dearborn, Dearborn Heights, Westland/Wayne County CoC",456,23,433,545.0,553.25
2014,MI-503,"St. Clair Shores, Warren/Macomb County CoC",343,58,285,545.0,530.0
2014,MI-504,"Pontiac, Royal Oak/Oakland County CoC",457,52,405,545.0,539.1666666666666
2014,MI-505,Flint/Genesee County CoC,635,105,530,450.0,483.6666666666667
2014,MI-506,"Grand Rapids, Wyoming/Kent County CoC",793,73,720,551.0,521.6
2014,MI-507,"Portage, Kalamazoo City & County CoC",681,54,627,493.0,502.5833333333333
2014,MI-508,"Lansing, East Lansing/Ingham County CoC",429,62,367,517.0,516.75
2014,MI-509,Washtenaw County CoC,545,139,406,715.0,521.8333333333334
2014,MI-510,Saginaw City & County CoC,325,15,310,458.0,455.8
2014,MI-511,Lenawee County CoC,138,6,132,598.0,490.6666666666667
2014,MI-512,"Grand Traverse, Antrim, Leelanau Counties CoC",396,91,305,567.46875,475.01041666666663
2014,MI-514,Battle Creek/Calhoun County CoC,284,33,251,443.0,504.625
2014,MI-515,Monroe City & County CoC,185,20,165,540.0,552.5
2014,MI-516,"Norton Shores, Muskegon City & County CoC",584,63,521,409.0,559.8
2014,MI-517,Jackson City & County CoC,240,15,225,540.0,535.7142857142857
2014,MI-518,Livingston County CoC,135,15,120,568.0,529.1666666666666
2014,MI-519,Holland/Ottawa County CoC,387,7,380,672.0,541.2
2014,MI-523,Eaton County CoC,126,0,126,517.0,517.3333333333334
2014,MN-500,Minneapolis/Hennepin County CoC,3731,576,3155,648.0,628.0
2014,MN-501,Saint Paul/Ramsey County CoC,1500,247,1253,648.0,628.0
2014,MN-502,Rochester/Southeast Minnesota CoC,482,66,416,467.9113247863248,467.8076923076923
2014,MN-503,"Dakota, Anoka, Washington, Scott, Carver Counties",735,81,654,648.0,583.9166666666666
2014,MN-504,Northeast Minnesota CoC,200,18,182,521.0095238095239,460.02857142857135
2014,MN-505,St. Cloud/Central Minnesota CoC,607,52,555,589.251700680272,516.8316326530612
2014,MN-506,Northwest Minnesota CoC,299,50,249,456.0833333333333,465.4916666666667
2014,MN-508,Moorhead/West Central Minnesota CoC,214,26,188,442.46000000000004,434.65333333333336
2014,MN-509,Duluth/St.Louis County CoC,429,114,315,472.0,472.6
2014,MN-511,Southwest Minnesota CoC,180,5,175,470.9485754985755,499.03233618233617
2014,MO-500,St. Louis County CoC,402,15,387,567.0,579.0
2014,MO-501,St.Louis City CoC,1354,202,1152,567.0,579.0
2014,MO-503,"St. Charles City & County, Lincoln, Warren Counties CoC",896,79,817,567.0,544.9444444444445
2014,MO-600,"Springfield/Greene, Christian, Webster Counties CoC",656,101,555,468.0,411.1666666666667
2014,MO-602,"Joplin/Jasper, Newton Counties CoC",315,35,280,485.0,425.27777777777777
2014,MO-603,"St. Joseph/Andrew, Buchanan, DeKalb Counties CoC",200,54,146,548.0,443.5
2014,MO-606,Missouri Balance of State CoC,1528,190,1338,447.85688059537534,465.6591489536991
2014,MS-500,"Jackson/Rankin, Madison Counties CoC",846,176,670,538.3157894736842,429.49122807017545
2014,MS-501,Mississippi Balance of State CoC,954,45,909,474.35608251397724,509.719683824947
2014,MS-503,Gulf Port/Gulf Coast Regional CoC,426,61,365,654.047619047619,615.9166666666666
2014,MT-500,Montana Statewide CoC,1745,270,1475,489.2560606060606,493.7257575757576
2014,NC-500,Winston-Salem/Forsyth County CoC,515,99,416,581.0,544.0
2014,NC-501,Asheville/Buncombe County CoC,530,47,483,459.0,475.83333333333337
2014,NC-502,Durham City & County CoC,811,111,700,615.0,616.0
2014,NC-503,North Carolina Balance of State CoC,3195,415,2780,535.8771800013712,535.8318514328809
2014,NC-504,"Greensboro, High Point CoC",897,109,788,559.0,557.9
2014,NC-505,Charlotte/Mecklenberg CoC,2014,210,1804,663.0,564.5555555555555
2014,NC-506,"Wilmington/Brunswick, New Hanover, Pender Counties CoC",321,64,257,591.6666666666667,605.6666666666667
2014,NC-507,Raleigh/Wake County CoC,1170,98,1072,650.0,613.9166666666667
2014,NC-509,"Gastonia/Cleveland, Gaston, Lincoln Counties CoC",423,94,329,557.5666666666667,565.6666666666666
2014,NC-511,Fayetteville/Cumberland County CoC,653,127,526,686.0,493.3333333333333
2014,NC-513,Chapel Hill/Orange County CoC,108,23,85,615.0,572.5
2014,NC-516,Northwest North Carolina CoC,854,34,820,485.41895604395603,458.34065934065933
2014,ND-500,North Dakota Statewide CoC,1258,115,1143,520.4578598484849,412.7774621212121
2014,NE-500,Nebraska Balance of State CoC,560,73,487,423.45847069597073,447.4812805250305
2014,NE-501,"Omaha, Council Bluffs CoC",1630,247,1383,499.0,481.91666666666663
2014,NE-502,Lincoln CoC,836,106,730,446.0,445.5
2014,NH-500,New Hampshire Balance of State CoC,689,187,502,721.7534909909909,749.9827256948814
2014,NH-502,Nashua/Hillsborough County CoC,280,80,200,784.774193548387,814.5555104123731
2014,NJ-500,Atlantic City & County CoC,544,141,403,847.0,860.0833333333334
2014,NJ-501,Bergen County CoC,371,35,336,1179.0,1160.6666666666667
2014,NJ-502,Burlington County CoC,1020,157,863,799.0,893.1428571428571
2014,NJ-503,"Camden City & County/Gloucester, Cape May, Cumberland Counties CoC",1695,158,1537,782.1666666666666,794.9583333333334
2014,NJ-504,Newark/Essex County CoC,1483,174,1309,1097.0,1090.2
2014,NJ-506,"Jersey City, Bayonne/Hudson County CoC",821,156,665,1073.0,1132.75
2014,NJ-507,New Brunswick/Middlesex County CoC,802,105,697,998.0,1061.0
2014,NJ-508,Monmouth County CoC,588,80,508,984.0,1009.8
2014,NJ-509,Morris County CoC,389,57,332,1097.0,1019.1333333333334
2014,NJ-510,Lakewood Township/Ocean County CoC,627,120,507,984.0,899.0
2014,NJ-511,Paterson/Passaic County CoC,376,17,359,1179.0,1079.6666666666667
2014,NJ-513,Somerset County CoC,323,14,309,998.0,995.2
2014,NJ-514,Trenton/Mercer County CoC,632,64,568,958.0,920.3333333333334
2014,NJ-515,Elizabeth/Union County CoC,1679,82,1597,1097.0,1073.3333333333333
2014,NJ-516,"Warren, Sussex, Hunterdon Counties CoC",279,38,241,992.7380952380952,932.9642857142857
2014,NM-501,New Mexico Balance of State CoC,1492,509,983,514.1578282828283,497.8253968253968
2014,NV-500,Las Vegas/Clark County CoC,7443,460,6983,675.0,621.75
2014,NV-501,"Reno, Sparks/Washoe County CoC",769,124,645,586.0,610.2333333333333
2014,NV-502,Nevada Balance of State CoC,370,121,249,514.3584656084655,607.8536155202822
2014,NY-500,"Rochester, Irondequoit, Greece/Monroe County CoC",838,31,807,595.0,594.1666666666666
2014,NY-501,"Elmira/Steuben, Allegany, Livingston, Chemung, Schuyler Counties CoC",512,65,447,539.6500000000001,546.1833333333333
2014,NY-503,Albany City & County CoC,650,81,569,704.0,690.0
2014,NY-505,"Syracuse, Auburn/Onondaga, Oswego, Cayuga Counties CoC",1024,90,934,581.6666666666667,629.9666666666666
2014,NY-507,Schenectady City & County CoC,243,26,217,704.0,681.3333333333334
2014,NY-508,"Buffalo, Niagara Falls/Erie, Niagara, Orleans, Genesee, Wyoming Counties CoC",1088,98,990,529.625,568.5833333333334
2014,NY-510,Ithaca/Tompkins County CoC,47,5,42,829.0,538.375
2014,NY-511,"Binghamton, Union Town/Broome, Otsego, Chenango, Delaware, Cortland, Tioga Count",309,24,285,581.5687499999999,620.55625
2014,NY-512,Troy/Rensselaer County CoC,216,47,169,704.0,647.7125
2014,NY-513,"Wayne, Ontario, Seneca, Yates Counties CoC",92,34,58,551.775,607.8
2014,NY-514,"Jamestown, Dunkirk/Chautauqua County CoC",53,11,42,503.0,523.0
2014,NY-518,"Utica, Rome/Oneida, Madison Counties CoC",159,32,127,625.9375,575.5
2014,NY-519,"Columbia, Greene Counties CoC",128,16,112,704.5,716.0803571428571
2014,NY-520,"Franklin, Essex Counties CoC",78,6,72,575.3,634.6
2014,NY-522,"Jefferson, Lewis, St. Lawrence Counties CoC",149,1,148,565.6333333333333,583.0666666666667
2014,NY-523,"Glens Falls, Saratoga Springs/Saratoga, Washington, Warren, Hamilton Counties Co",262,37,225,648.2857142857143,634.75
2014,NY-600,New York City CoC,67810,5873,61937,1292.0,1064.0
2014,NY-601,Poughkeepsie/Dutchess County CoC,403,9,394,940.0,888.7884316770186
2014,NY-602,"Newburgh, Middletown/Orange County CoC",421,84,337,940.0,1008.5714285714286
2014,NY-603,"Nassau, Suffolk Counties CoC",3207,367,2840,1126.0,979.0547964113182
2014,NY-604,"Yonkers, Mount Vernon/Westchester County CoC",2138,205,1933,1053.0,1195.8260869565217
2014,NY-606,Rockland County CoC,125,6,119,1292.0,1109.0
2014,NY-608,Kingston/Ulster County CoC,341,36,305,703.0,756.8
2014,OH-500,Cincinnati/Hamilton County CoC,1043,166,877,472.0,477.0
2014,OH-501,Toledo/Lucas County CoC,809,107,702,429.0,494.6666666666667
2014,OH-502,Cleveland/Cuyahoga County CoC,2103,252,1851,526.0,529.2
2014,OH-503,Columbus/Franklin County CoC,1614,257,1357,527.0,514.5
2014,OH-504,Youngstown/Mahoning County CoC,256,88,168,468.0,464.3333333333333
2014,OH-505,"Dayton, Kettering/Montgomery County CoC",791,39,752,516.0,481.42857142857144
2014,OH-506,"Akron, Barberton/Summit County CoC",870,219,651,513.0,480.0833333333333
2014,OH-507,Ohio Balance of State CoC,3806,282,3524,453.9909119203237,480.5978576615832
2014,OH-508,"Canton, Massillon, Alliance/Stark County CoC",531,71,460,431.0,480.77777777777777
2014,OK-500,North Central Oklahoma CoC,201,29,172,475.6333333333333,417.8
2014,OK-501,Tulsa City & County CoC,1010,99,911,496.0,426.88888888888886
2014,OK-502,Oklahoma City CoC,1481,249,1232,518.0,498.66666666666663
2014,OK-503,Oklahoma Balance of State CoC,295,40,255,449.4843304843305,447.1604938271605
2014,OK-504,Norman/Cleveland County CoC,140,48,92,518.0,535.0
2014,OK-505,Northeast Oklahoma CoC,383,103,280,454.48639455782313,455.92176870748295
2014,OK-506,Southwest Oklahoma Regional CoC,239,30,209,445.7770833333333,456.1020833333333
2014,OK-507,Southeastern Oklahoma Regional CoC,442,73,369,420.8958333333333,459.8729166666667
2014,OR-500,"Eugene, Springfield/Lane County CoC",1767,412,1355,525.0,541.2
2014,OR-501,"Portland, Gresham/Multnomah County CoC",3927,1102,2825,700.0,693.5
2014,OR-502,"Medford, Ashland/Jackson County CoC",625,84,541,640.0,519.6666666666666
2014,OR-503,Central Oregon CoC,568,130,438,488.8,504.6333333333334
2014,OR-505,Oregon Balance of State CoC,4122,653,3469,519.3785879629629,565.249537037037
2014,OR-506,"Hillsboro, Beaverton/Washington County CoC",537,117,420,700.0,665.5
2014,OR-507,Clackamas County CoC,618,197,421,700.0,646.0
2014,PA-500,Philadelphia CoC,5738,702,5036,799.0,788.0
2014,PA-501,Harrisburg/Dauphin County CoC,396,50,346,634.0,564.1666666666666
2014,PA-502,"Upper Darby, Chester, Haverford/Delaware County CoC",509,46,463,799.0,788.0
2014,PA-503,"Wilkes-Barre, Hazleton/Luzerne County CoC",192,0,192,501.0,548.4166666666667
2014,PA-504,"Lower Merion, Norristown, Abington/Montgomery County CoC",438,28,410,799.0,732.0
2014,PA-505,Chester County CoC,679,79,600,799.0,728.5
2014,PA-506,Reading/Berks County CoC,604,68,536,559.0,687.8333333333334
2014,PA-508,Scranton/Lackawanna County CoC,287,23,264,501.0,549.5
2014,PA-509,Eastern Pennsylvania CoC,2021,139,1882,609.6947916666667,655.6645833333333
2014,PA-510,Lancaster City & County CoC,498,10,488,663.0,649.0
2014,PA-511,"Bristol, Bensalem/Bucks County CoC",492,27,465,799.0,802.3333333333334
2014,PA-512,York City & County CoC,302,47,255,528.0,756.5833333333334
2014,PA-600,"Pittsburgh, McKeesport, Penn Hills/Allegheny County CoC",1573,198,1375,595.0,582.0
2014,PA-601,Western Pennsylvania CoC,1101,135,966,527.8472222222223,529.7569444444445
2014,PA-603,Beaver County CoC,95,9,86,595.0,491.83333333333337
2014,PA-605,Erie City & County CoC,408,46,362,469.0,495.6666666666667
2014,PR-502,Puerto Rico Balance of Commonwealth CoC,2085,634,1451,432.5882352941176,456.4117647058824
2014,PR-503,South-Southeast Puerto Rico CoC,2047,1429,618,440.94117647058823,440.7352941176471
2014,RI-500,Rhode Island Statewide CoC,1190,204,986,702.8000000000001,863.1895238095237
2014,SC-500,Charleston/Low Country CoC,516,37,479,593.0952380952381,548.8333333333334
2014,SC-501,"Greenville, Anderson, Spartanburg/Upstate CoC",1636,76,1560,534.3111111111111,531.5044444444444
2014,SC-502,Columbia/Midlands CoC,1588,62,1526,550.6442743764172,589.1102607709751
2014,SC-503,"Myrtle Beach, Sumter City & County CoC",1317,98,1219,567.1278409090909,617.9090909090909
2014,SD-500,South Dakota Statewide CoC,885,118,767,464.8770604395604,410.34307953950804
2014,TN-500,Chattanooga/Southeast Tennessee CoC,627,168,459,438.1547619047619,449.9920634920635
2014,TN-501,Memphis/Shelby County CoC,1675,149,1526,617.0,555.6666666666666
2014,TN-502,Knoxville/Knox County CoC,861,149,712,524.0,462.2857142857143
2014,TN-503,Central Tennessee CoC,286,28,258,504.5547619047619,503.92232142857137
2014,TN-504,Nashville-Davidson County CoC,2234,1006,1228,653.0,631.0
2014,TN-506,Upper Cumberland CoC,342,31,311,497.89024943310653,518.1215419501134
2014,TN-507,Jackson/West Tennessee CoC,1601,260,1341,463.88095238095235,459.4345238095238
2014,TN-509,Appalachian Regional CoC,598,179,419,416.92261904761904,450.8988095238095
2014,TN-510,Murfreesboro/Rutherford County CoC,258,78,180,653.0,583.6666666666666
2014,TN-512,"Morristown/Blount, Sevier, Campbell, Cocke Counties CoC",933,147,786,434.8098639455783,435.51547619047614
2014,TX-500,San Antonio/Bexar County CoC,2892,614,2278,576.0,557.2857142857143
2014,TX-503,Austin/Travis County CoC,1987,384,1603,696.0,644.6666666666666
2014,TX-600,"Dallas City & County, Irving CoC",3514,489,3025,644.0,600.8888888888889
2014,TX-601,"Fort Worth, Arlington/Tarrant County CoC",2425,331,2094,620.0,591.15
2014,TX-603,El Paso City & County CoC,1260,179,1081,602.0,444.0
2014,TX-604,Waco/McLennan County CoC,246,32,214,499.9666666666667,579.4333333333334
2014,TX-607,Texas Balance of State CoC,9943,2434,7509,523.2476334123394,538.8128312863606
2014,TX-624,"Wichita Falls/Wise, Palo Pinto, Wichita, Archer Counties CoC",281,75,206,503.26904761904757,475.12142857142857
2014,TX-700,"Houston, Pasadena, Conroe/Harris, Ft. Bend, Montgomery, Counties CoC",5308,769,4539,623.0,545.6538461538462
2014,TX-701,"Bryan, College Station/Brazos Valley CoC",188,23,165,531.3384615384615,559.1999999999999
2014,UT-500,Salt Lake City & County CoC,2150,369,1781,621.0,571.3333333333333
2014,UT-503,Utah Balance of State CoC,782,47,735,531.1270833333333,556.54375
2014,UT-504,Provo/Mountainland CoC,149,6,143,632.7555555555556,575.4333333333333
2014,VA-500,"Richmond/Henrico, Chesterfield, Hanover Counties CoC",846,74,772,790.0,792.3541666666666
2014,VA-501,"Norfolk, Chesapeake, Suffolk/Isle of Wight, Southampton Counties CoC",668,48,620,823.7380952380952,790.9464285714286
2014,VA-502,"Roanoke City & County, Salem CoC",440,62,378,526.1111111111112,516.1111111111111
2014,VA-503,Virginia Beach CoC,440,86,354,913.0,918.0
2014,VA-504,Charlottesville CoC,204,32,172,668.2878787878789,641.2878787878789
2014,VA-505,"Newport News, Hampton/Virginia Peninsula CoC",525,131,394,913.0,866.6666666666666
2014,VA-508,Lynchburg CoC,220,32,188,525.0,603.8000000000001
2014,VA-513,"Harrisburg, Winchester/Western Virginia CoC",249,53,196,598.75,632.0238095238095
2014,VA-514,"Fredericksburg/Spotsylvania, Stafford Counties CoC",201,45,156,780.2,752.4
2014,VA-521,Virginia Balance of State CoC,662,31,631,595.0568924131424,596.9984407953158
2014,VA-603,Alexandria CoC,267,63,204,1272.0,1226.0
2014,VT-500,Vermont Balance of State CoC,1027,132,895,692.4666666666666,650.4997710622711
2014,VT-501,Burlington/Chittenden County CoC,532,151,381,967.0,622.7333333333333
2014,WA-500,Seattle/King County CoC,8949,885,8064,828.0,661.2222222222222
2014,WA-501,Washington Balance of State CoC,5236,979,4257,502.92013888888886,626.9791666666666
2014,WA-502,Spokane City & County CoC,1149,179,970,473.0,498.375
2014,WA-503,"Tacoma, Lakewood/Pierce County CoC",1464,224,1240,669.0,704.125
2014,WA-504,Everett/Snohomish County CoC,949,188,761,828.0,692.5
2014,WI-500,Wisconsin Balance of State CoC,3569,246,3323,517.9793929267613,553.5051851851852
2014,WI-501,Milwaukee City & County CoC,1499,127,1372,557.0,540.0
2014,WI-502,Racine City & County CoC,210,12,198,583.0,587.0833333333334
2014,WI-503,Madison/Dane County CoC,777,139,638,658.0,500.14285714285717
2014,WV-500,"Wheeling, Weirton Area CoC",97,23,74,454.3333333333333,509.9666666666667
2014,WV-501,"Huntington/Cabell, Wayne Counties CoC",218,50,168,408.0,430.2916666666667
2014,WV-503,"Charleston/Kanawha, Putnam, Boone, Clay Counties CoC",360,51,309,563.7058823529412,419.2647058823529
2014,WV-508,West Virginia Balance of State CoC,1338,358,980,492.92076186885015,483.1369038641098
2014,WY-500,Wyoming Statewide CoC,757,144,613,569.0657467532467,548.8709415584415
2013,AK-500,Anchorage CoC,1122,89,1033,780.0,
2013,AK-501,Alaska Balance of State CoC,824,95,729,689.0,
2013,AL-500,"Birmingham/Jefferson, St. Clair, Shelby Counties CoC",1469,427,1042,605.0,
2013,AL-501,Mobile City & County/Baldwin County CoC,493,91,402,594.8,
2013,AL-502,Florence/Northwest Alabama CoC,223,30,193,451.6,
2013,AL-503,Huntsville/North Alabama CoC,586,120,466,497.375,
2013,AL-504,Montgomery City & County CoC,515,69,446,628.5625,
2013,AL-506,Tuscaloosa City & County CoC,99,9,90,494.0,
2013,AL-507,Alabama Balance of State CoC,905,72,833,485.48648818501766,
2013,AR-500,Little Rock/Central Arkansas CoC,1066,373,693,528.1333333333333,
2013,AR-501,Fayetteville/Northwest Arkansas CoC,668,65,603,490.0,
2013,AR-503,Arkansas  Balance of State  CoC,2014,160,1854,467.3235294117647,
2013,AR-505,Southeast Arkansas CoC,64,4,60,425.92380952380955,
2013,AZ-500,Arizona Balance of State CoC,2435,329,2106,525.8733333333332,
2013,AZ-501,Tucson/Pima County CoC,2238,360,1878,521.0,
2013,AZ-502,"Phoenix, Mesa/Maricopa County CoC",5889,499,5390,593.0,
2013,CA-500,San Jose/Santa Clara City & County CoC,7631,2518,5113,1160.0,
2013,CA-501,San Francisco CoC,7008,2093,4915,1205.0,
2013,CA-502,"Oakland, Berkeley/Alameda County CoC",4264,1054,3210,963.0,
2013,CA-503,Sacramento City & County CoC,2538,440,2098,717.0,
2013,CA-504,"Santa Rosa, Petaluma/Sonoma County CoC",4280,1168,3112,926.0,
2013,CA-505,Richmond/Contra Costa County CoC,2000,754,1246,963.0,
2013,CA-506,"Salinas/Monterey, San Benito Counties CoC",2955,1038,1917,839.0,
2013,CA-507,Marin County CoC,676,89,587,1205.0,
2013,CA-508,Watsonville/Santa Cruz City & County CoC,3536,989,2547,1039.0,
2013,CA-509,Mendocino County CoC,1392,227,1165,753.0,
2013,CA-510,"Turlock, Modesto/Stanislaus County CoC",1201,205,996,628.0,
2013,CA-511,Stockton/San Joaquin County CoC,1541,204,1337,676.0,
2013,CA-512,Daly/San Mateo County CoC,1995,889,1106,1205.0,
2013,CA-513,"Visalia/Kings, Tulare Counties CoC",705,187,518,557.2,
2013,CA-514,Fresno City & County/Madera County CoC,3131,793,2338,701.6666666666667,
2013,CA-515,"Roseville, Rocklin/Placer County CoC",908,222,686,717.0,
2013,CA-516,"Redding/Shasta, Siskiyou, Lassen, Plumas, Del Norte, Modoc, Sierra Counties CoC",851,199,652,618.7592592592594,
2013,CA-517,Napa City & County CoC,245,81,164,835.0,
2013,CA-518,Vallejo/Solano County CoC,1329,414,915,787.0,
2013,CA-519,"Chico, Paradise/Butte County CoC",712,312,400,564.0,
2013,CA-520,Merced City & County CoC,372,181,191,536.0,
2013,CA-521,"Davis, Woodland/Yolo County CoC",474,134,340,802.0,
2013,CA-522,Humboldt County CoC,864,276,588,702.0,
2013,CA-523,"Colusa, Glenn, Trinity Counties CoC",696,303,393,610.75,
2013,CA-524,Yuba City & County/Sutter County CoC,1485,104,1381,556.0,
2013,CA-525,El Dorado County CoC,180,55,125,717.0,
2013,CA-526,"Amador, Calaveras, Mariposa, Tuolumne Counties CoC",376,130,246,687.6904761904763,
2013,CA-600,Los Angeles City & County CoC,35524,8702,26822,988.0,
2013,CA-601,San Diego City and County CoC,8879,2531,6348,1037.0,
2013,CA-602,"Santa Ana, Anaheim/Orange County CoC",4251,829,3422,1126.0,
2013,CA-603,Santa Maria/Santa Barbara County CoC,1882,913,969,1157.0,
2013,CA-604,Bakersfield/Kern County CoC,1152,286,866,649.0,
2013,CA-608,Riverside City & County CoC,2978,1117,1861,763.0,
2013,CA-609,San Bernardino City & County CoC,2321,596,1725,763.0,
2013,CA-611,"Oxnard, San Buenaventura/Ventura County CoC",1674,797,877,1003.0,
2013,CA-613,Imperial County CoC,252,138,114,548.0,
2013,CA-614,San Luis Obispo County CoC,2357,707,1650,814.0,
2013,CO-500,Colorado Balance of State CoC,2267,579,1688,529.0452136752136,
2013,CO-503,Metropolitan Denver CoC,6316,889,5427,661.6538461538462,
2013,CO-504,Colorado Springs/El Paso County CoC,1171,312,859,543.0,
2013,CT-503,"Bridgeport, Stamford, Norwalk, Danbury/Fairfield County CoC",1059,252,807,1007.9565217391304,
2013,CT-505,Connecticut Balance of State CoC,3389,794,2595,765.7698412698412,
2013,DE-500,Delaware Statewide CoC,946,71,875,764.25,
2013,FL-500,"Sarasota, Bradenton/Manatee, Sarasota Counties CoC",1049,301,748,722.0,
2013,FL-501,Tampa/Hillsborough County CoC,1909,506,1403,618.0,
2013,FL-502,"St. Petersburg, Clearwater, Largo/Pinellas County CoC",3913,375,3538,618.0,
2013,FL-503,"Lakeland, Winterhaven/Polk County CoC",520,172,348,663.0,
2013,FL-504,"Deltona, Daytona Beach/Volusia, Flagler Counties CoC",2176,259,1917,635.25,
2013,FL-505,"Fort Walton Beach/Okaloosa, Walton Counties CoC",1658,352,1306,722.0,
2013,FL-506,Tallahassee/Leon County CoC,974,259,715,588.4814814814814,
2013,FL-507,"Orlando/Orange, Osceola, Seminole Counties CoC",4378,1577,2801,739.0,
2013,FL-508,"Gainesville/Alachua, Putnam Counties CoC",1718,528,1190,589.6666666666666,
2013,FL-509,"Fort Pierce/St. Lucie, Indian River, Martin Counties CoC",2240,196,2044,656.6,
2013,FL-510,"Jacksonville-Duval, Clay Counties CoC",2768,365,2403,655.0,
2013,FL-511,"Pensacola/Escambia, Santa Rosa Counties CoC",945,243,702,617.0,
2013,FL-512,St. Johns County CoC,1437,56,1381,655.0,
2013,FL-513,"Palm Bay, Melbourne/Brevard County CoC",1567,115,1452,571.0,
2013,FL-514,Ocala/Marion County CoC,530,91,439,556.0,
2013,FL-515,"Panama City/Bay, Jackson Counties CoC",301,38,263,495.1666666666667,
2013,FL-517,"Hendry, Hardee, Highlands Counties CoC",3847,681,3166,640.3116666666667,
2013,FL-518,"Columbia, Hamilton, Lafayette, Suwannee Counties CoC",1278,289,989,468.93333333333334,
2013,FL-519,Pasco County CoC,3305,1200,2105,618.0,
2013,FL-520,"Citrus, Hernando, Lake, Sumter Counties CoC",709,46,663,671.5833333333334,
2013,FL-600,Miami-Dade County CoC,3802,618,3184,776.0,
2013,FL-601,Ft Lauderdale/Broward County CoC,2810,411,2399,748.0,
2013,FL-602,Punta Gorda/Charlotte County CoC,573,211,362,545.0,
2013,FL-603,"Ft Myers, Cape Coral/Lee County CoC",848,180,668,760.0,
2013,FL-604,Monroe County CoC,652,173,479,1265.0,
2013,FL-605,West Palm Beach/Palm Beach County CoC,1559,373,1186,738.0,
2013,FL-606,Naples/Collier County CoC,396,32,364,779.0,
2013,GA-500,Atlanta CoC,5536,1431,4105,719.0,
2013,GA-501,Georgia Balance of State CoC,7651,1136,6515,573.1530372933488,
2013,GA-503,Athens-Clarke County CoC,213,67,146,614.0,
2013,GA-504,Augusta-Richmond County CoC,476,62,414,587.0,
2013,GA-505,Columbus-Muscogee CoC,294,58,236,580.0,
2013,GA-506,Marietta/Cobb County CoC,495,60,435,719.0,
2013,GA-507,Savannah/Chatham County CoC,1165,131,1034,638.0,
2013,GA-508,DeKalb County CoC,713,82,631,719.0,
2013,IA-500,"Sioux City/Dakota, Woodbury Counties CoC",236,65,171,416.0,
2013,IA-501,Iowa Balance of State CoC,1920,145,1775,414.5582084582085,
2013,IA-502,Des Moines/Polk County CoC,928,117,811,531.0,
2013,ID-500,Boise/Ada County CoC,694,108,586,455.0,
2013,ID-501,Idaho Balance of State CoC,1087,163,924,463.0888888888889,
2013,IL-500,McHenry County CoC,185,9,176,768.0,
2013,IL-501,"Rockford/DeKalb, Winnebago, Boone Counties CoC",895,268,627,532.8,
2013,IL-502,"Waukegan, North Chicago/Lake County CoC",497,62,435,768.0,
2013,IL-503,"Champaign, Urbana, Rantoul/Champaign County CoC",214,8,206,553.0,
2013,IL-506,"Joliet, Bolingbrook/Will County CoC",288,17,271,747.3095238095237,
2013,IL-507,"Peoria, Pekin/Fulton, Tazewell, Peoria, Woodford Counties CoC",396,52,344,477.6666666666667,
2013,IL-511,Cook County CoC,1242,109,1133,768.0,
2013,IL-512,Bloomington/Central Illinois CoC,536,62,474,482.70767195767195,
2013,IL-513,Springfield/Sangamon County CoC,280,87,193,468.0,
2013,IL-514,DuPage County CoC,665,74,591,768.0,
2013,IL-515,South Central Illinois CoC,149,21,128,464.78950617283954,
2013,IL-516,Decatur/Macon County CoC,247,69,178,405.0,
2013,IL-517,"Aurora, Elgin/Kane County CoC",451,109,342,768.0,
2013,IL-518,"Rock Island, Moline/Northwestern Illinois CoC",219,0,219,456.2687074829932,
2013,IL-519,West Central Illinois CoC,133,4,129,424.71360544217686,
2013,IL-520,Southern Illinois CoC,338,35,303,399.27777777777777,
2013,IN-502,Indiana Balance of State CoC,4497,398,4099,483.8421755368814,
2013,IN-503,Indianapolis CoC,1599,182,1417,530.0,
2013,KS-502,Wichita/Sedgwick County CoC,538,91,447,454.0,
2013,KS-503,Topeka/Shawnee County CoC,439,83,356,440.0,
2013,KS-507,Kansas Balance of State CoC,1141,129,1012,420.835705960706,
2013,KY-500,Kentucky Balance of State CoC,2392,356,2036,439.39603174603184,
2013,KY-501,Louisville-Jefferson County CoC,1445,145,1300,536.0,
2013,KY-502,Lexington-Fayette County CoC,1408,40,1368,487.0,
2013,LA-500,Lafayette/Acadiana CoC,542,83,459,469.3076923076923,
2013,LA-502,"Shreveport, Bossier/Northwest Louisiana CoC",692,155,537,496.4027777777778,
2013,LA-503,New Orleans/Jefferson Parish CoC,2337,677,1660,678.0,
2013,LA-505,Monroe/Northeast Louisiana CoC,200,23,177,469.4976190476191,
2013,LA-506,Slidell/Southeast Louisiana CoC,276,31,245,608.8854166666666,
2013,LA-507,Alexandria/Central Louisiana CoC,118,9,109,446.85515873015873,
2013,LA-509,Louisiana Balance of State CoC,1061,137,924,593.1153846153846,
2013,MA-500,Boston CoC,5881,543,5338,1125.0,
2013,MA-503,Cape Cod Islands CoC,514,149,365,904.25,
2013,MA-504,Springfield/Hampden County CoC,2117,332,1785,662.0,
2013,MA-506,Worcester City & County CoC,1657,69,1588,664.15,
2013,MA-507,"Pittsfield/Berkshire, Franklin, Hampshire Counties CoC",678,117,561,668.7981770833334,
2013,MA-511,"Quincy, Brockton, Weymouth, Plymouth City and County CoC",1690,171,1519,1010.925925925926,
2013,MA-516,Massachusetts Balance of State CoC,4666,428,4238,1085.8541935292635,
2013,MA-519,"Attleboro, Taunton/Bristol County CoC",251,10,241,792.25,
2013,MD-501,Baltimore CoC,2638,226,2412,846.0,
2013,MD-503,Annapolis/Anne Arundel County CoC,400,63,337,846.0,
2013,MD-505,Baltimore County CoC,919,261,658,846.0,
2013,MD-506,Carroll County CoC,134,27,107,846.0,
2013,MD-511,Mid-Shore Regional CoC,87,19,68,791.0666666666666,
2013,MD-513,"Wicomico, Somerset, Worcester Counties CoC",360,51,309,542.5,
2013,MD-514,Maryland Balance of State CoC,1783,473,1310,741.7613636363636,
2013,ME-500,Maine Statewide CoC,3016,176,2840,632.9103448275862,
2013,MI-500,Michigan Balance of State CoC,1880,99,1781,497.0994318181818,
2013,MI-502,"Dearborn, Dearborn Heights, Westland/Wayne County CoC",380,20,360,530.0,
2013,MI-503,"St. Clair Shores, Warren/Macomb County CoC",504,70,434,530.0,
2013,MI-504,"Pontiac, Royal Oak/Oakland County CoC",698,64,634,530.0,
2013,MI-505,Flint/Genesee County CoC,387,25,362,452.0,
2013,MI-506,"Grand Rapids, Wyoming/Kent County CoC",732,117,615,551.0,
2013,MI-507,"Portage, Kalamazoo City & County CoC",642,48,594,488.0,
2013,MI-508,"Lansing, East Lansing/Ingham County CoC",423,67,356,539.0,
2013,MI-509,Washtenaw County CoC,510,116,394,675.0,
2013,MI-510,Saginaw City & County CoC,350,16,334,426.0,
2013,MI-511,Lenawee County CoC,124,12,112,573.0,
2013,MI-512,"Grand Traverse, Antrim, Leelanau Counties CoC",328,40,288,557.5520833333333,
2013,MI-514,Battle Creek/Calhoun County CoC,236,22,214,481.0,
2013,MI-515,Monroe City & County CoC,139,2,137,478.0,
2013,MI-516,"Norton Shores, Muskegon City & County CoC",644,64,580,413.0,
2013,MI-517,Jackson City & County CoC,187,13,174,502.0,
2013,MI-518,Livingston County CoC,127,10,117,518.0,
2013,MI-519,Holland/Ottawa County CoC,318,3,315,606.0,
2013,MI-523,Eaton County CoC,129,7,122,539.0,
2013,MN-500,Minneapolis/Hennepin County CoC,3591,533,3058,628.0,
2013,MN-501,Saint Paul/Ramsey County CoC,1417,288,1129,628.0,
2013,MN-502,Rochester/Southeast Minnesota CoC,452,73,379,458.4038461538462,
2013,MN-503,"Dakota, Anoka, Washington, Scott, Carver Counties",745,89,656,628.0,
2013,MN-504,Northeast Minnesota CoC,265,40,225,494.43428571428575,
2013,MN-505,St. Cloud/Central Minnesota CoC,657,114,543,567.5918367346939,
2013,MN-506,Northwest Minnesota CoC,253,36,217,438.25,
2013,MN-508,Moorhead/West Central Minnesota CoC,287,62,225,434.04666666666674,
2013,MN-509,Duluth/St.Louis County CoC,410,103,307,499.0,
2013,MN-511,Southwest Minnesota CoC,137,12,125,451.30548433048426,
2013,MO-500,St. Louis County CoC,388,116,272,579.0,
2013,MO-501,St.Louis City CoC,1423,138,1285,579.0,
2013,MO-503,"St. Charles City & County, Lincoln, Warren Counties CoC",940,78,862,579.0,
2013,MO-600,"Springfield/Greene, Christian, Webster Counties CoC",711,105,606,471.0,
2013,MO-602,"Joplin/Jasper, Newton Counties CoC",574,18,556,474.0,
2013,MO-603,"St. Joseph/Andrew, Buchanan, DeKalb Counties CoC",186,96,90,466.0,
2013,MO-606,Missouri Balance of State CoC,2030,208,1822,438.23298182017913,
2013,MS-500,"Jackson/Rankin, Madison Counties CoC",760,277,483,545.3684210526316,
2013,MS-501,Mississippi Balance of State CoC,1052,58,994,433.3287786774629,
2013,MS-503,Gulf Port/Gulf Coast Regional CoC,591,140,451,638.4880952380952,
2013,MT-500,Montana Statewide CoC,1878,227,1651,425.78333333333336,
2013,NC-500,Winston-Salem/Forsyth County CoC,394,82,312,574.0,
2013,NC-501,Asheville/Buncombe County CoC,570,54,516,496.0,
2013,NC-502,Durham City & County CoC,753,87,666,610.0,
2013,NC-503,North Carolina Balance of State CoC,3625,636,2989,526.9157868846839,
2013,NC-504,"Greensboro, High Point CoC",949,148,801,553.0,
2013,NC-505,Charlotte/Mecklenberg CoC,2418,158,2260,644.0,
2013,NC-506,"Wilmington/Brunswick, New Hanover, Pender Counties CoC",348,64,284,583.75,
2013,NC-507,Raleigh/Wake County CoC,1098,140,958,669.0,
2013,NC-509,"Gastonia/Cleveland, Gaston, Lincoln Counties CoC",384,112,272,528.4,
2013,NC-511,Fayetteville/Cumberland County CoC,631,293,338,627.0,
2013,NC-513,Chapel Hill/Orange County CoC,123,28,95,610.0,
2013,NC-516,Northwest North Carolina CoC,875,40,835,455.5975274725275,
2013,ND-500,North Dakota Statewide CoC,2069,179,1890,434.6150568181818,
2013,NE-500,Nebraska Balance of State CoC,713,105,608,427.1625228937729,
2013,NE-501,"Omaha, Council Bluffs CoC",1476,180,1296,524.0,
2013,NE-502,Lincoln CoC,956,129,827,442.0,
2013,NH-500,New Hampshire Balance of State CoC,759,143,616,732.9203828828828,
2013,NH-502,Nashua/Hillsborough County CoC,306,28,278,781.0645161290323,
2013,NJ-500,Atlantic City & County CoC,746,124,622,876.0,
2013,NJ-501,Bergen County CoC,346,33,313,1132.0,
2013,NJ-502,Burlington County CoC,671,85,586,788.0,
2013,NJ-503,"Camden City & County/Gloucester, Cape May, Cumberland Counties CoC",1291,138,1153,774.4166666666666,
2013,NJ-504,Newark/Essex County CoC,1646,207,1439,1044.0,
2013,NJ-506,"Jersey City, Bayonne/Hudson County CoC",942,145,797,1099.0,
2013,NJ-507,New Brunswick/Middlesex County CoC,1031,100,931,971.0,
2013,NJ-508,Monmouth County CoC,918,68,850,1033.0,
2013,NJ-509,Morris County CoC,346,48,298,1044.0,
2013,NJ-510,Lakewood Township/Ocean County CoC,682,90,592,1033.0,
2013,NJ-511,Paterson/Passaic County CoC,440,42,398,1132.0,
2013,NJ-513,Somerset County CoC,312,39,273,971.0,
2013,NJ-514,Trenton/Mercer County CoC,668,58,610,946.0,
2013,NJ-515,Elizabeth/Union County CoC,1648,27,1621,1044.0,
2013,NJ-516,"Warren, Sussex, Hunterdon Counties CoC",271,33,238,948.7380952380952,
2013,NM-501,New Mexico Balance of State CoC,1648,292,1356,477.58225108225105,
2013,NV-500,Las Vegas/Clark County CoC,5952,529,5423,691.0,
2013,NV-501,"Reno, Sparks/Washoe County CoC",746,150,596,604.0,
2013,NV-502,Nevada Balance of State CoC,341,45,296,498.7579365079365,
2013,NY-500,"Rochester, Irondequoit, Greece/Monroe County CoC",1007,91,916,615.0,
2013,NY-501,"Elmira/Steuben, Allegany, Livingston, Chemung, Schuyler Counties CoC",349,22,327,541.6500000000001,
2013,NY-503,Albany City & County CoC,728,101,627,697.0,
2013,NY-505,"Syracuse, Auburn/Onondaga, Oswego, Cayuga Counties CoC",994,123,871,565.6666666666667,
2013,NY-507,Schenectady City & County CoC,327,52,275,697.0,
2013,NY-508,"Buffalo, Niagara Falls/Erie, Niagara, Orleans, Genesee, Wyoming Counties CoC",1162,148,1014,549.4583333333333,
2013,NY-510,Ithaca/Tompkins County CoC,47,3,44,731.0,
2013,NY-511,"Binghamton, Union Town/Broome, Otsego, Chenango, Delaware, Cortland, Tioga Count",276,1,275,581.5125,
2013,NY-512,Troy/Rensselaer County CoC,188,44,144,697.0,
2013,NY-513,"Wayne, Ontario, Seneca, Yates Counties CoC",171,21,150,562.825,
2013,NY-514,"Jamestown, Dunkirk/Chautauqua County CoC",62,1,61,539.0,
2013,NY-518,"Utica, Rome/Oneida, Madison Counties CoC",200,37,163,587.9791666666666,
2013,NY-519,"Columbia, Greene Counties CoC",112,2,110,662.0,
2013,NY-520,"Franklin, Essex Counties CoC",34,9,25,564.5,
2013,NY-522,"Jefferson, Lewis, St. Lawrence Counties CoC",83,28,55,548.7333333333333,
2013,NY-523,"Glens Falls, Saratoga Springs/Saratoga, Washington, Warren, Hamilton Counties Co",262,24,238,617.5714285714286,
2013,NY-600,New York City CoC,64060,4328,59732,1311.0,
2013,NY-601,Poughkeepsie/Dutchess County CoC,397,25,372,903.0,
2013,NY-602,"Newburgh, Middletown/Orange County CoC",459,134,325,903.0,
2013,NY-603,"Nassau, Suffolk Counties CoC",3123,466,2657,1102.0,
2013,NY-604,"Yonkers, Mount Vernon/Westchester County CoC",2054,437,1617,1067.0,
2013,NY-606,Rockland County CoC,107,3,104,1311.0,
2013,NY-608,Kingston/Ulster County CoC,442,81,361,793.0,
2013,OH-500,Cincinnati/Hamilton County CoC,1326,274,1052,477.0,
2013,OH-501,Toledo/Lucas County CoC,900,149,751,432.0,
2013,OH-502,Cleveland/Cuyahoga County CoC,2129,303,1826,519.0,
2013,OH-503,Columbus/Franklin County CoC,1488,309,1179,513.0,
2013,OH-504,Youngstown/Mahoning County CoC,227,42,185,473.0,
2013,OH-505,"Dayton, Kettering/Montgomery County CoC",1041,64,977,534.0,
2013,OH-506,"Akron, Barberton/Summit County CoC",862,211,651,536.0,
2013,OH-507,Ohio Balance of State CoC,3830,330,3500,452.17186689490615,
2013,OH-508,"Canton, Massillon, Alliance/Stark County CoC",522,71,451,420.0,
2013,OK-500,North Central Oklahoma CoC,190,35,155,459.16666666666663,
2013,OK-501,Tulsa City & County CoC,1008,114,894,486.0,
2013,OK-502,Oklahoma City CoC,1362,313,1049,535.0,
2013,OK-503,Oklahoma Balance of State CoC,272,39,233,443.4056267806268,
2013,OK-504,Norman/Cleveland County CoC,368,44,324,535.0,
2013,OK-505,Northeast Oklahoma CoC,487,112,375,436.85714285714283,
2013,OK-506,Southwest Oklahoma Regional CoC,196,8,188,422.77500000000003,
2013,OK-507,Southeastern Oklahoma Regional CoC,525,54,471,409.225,
2013,OR-500,"Eugene, Springfield/Lane County CoC",1751,415,1336,517.0,
2013,OR-501,"Portland, Gresham/Multnomah County CoC",4441,1150,3291,694.0,
2013,OR-502,"Medford, Ashland/Jackson County CoC",548,172,376,635.0,
2013,OR-503,Central Oregon CoC,506,137,369,484.76666666666665,
2013,OR-505,Oregon Balance of State CoC,5525,901,4624,515.843287037037,
2013,OR-506,"Hillsboro, Beaverton/Washington County CoC",432,77,355,694.0,
2013,OR-507,Clackamas County CoC,619,191,428,694.0,
2013,PA-500,Philadelphia CoC,5645,633,5012,788.0,
2013,PA-501,Harrisburg/Dauphin County CoC,390,76,314,677.0,
2013,PA-502,"Upper Darby, Chester, Haverford/Delaware County CoC",546,38,508,788.0,
2013,PA-503,"Wilkes-Barre, Hazleton/Luzerne County CoC",165,3,162,536.0,
2013,PA-504,"Lower Merion, Norristown, Abington/Montgomery County CoC",464,18,446,788.0,
2013,PA-505,Chester County CoC,641,72,569,788.0,
2013,PA-506,Reading/Berks County CoC,468,88,380,571.0,
2013,PA-508,Scranton/Lackawanna County CoC,252,22,230,536.0,
2013,PA-509,Eastern Pennsylvania CoC,2081,202,1879,594.5458333333333,
2013,PA-510,Lancaster City & County CoC,518,34,484,648.0,
2013,PA-511,"Bristol, Bensalem/Bucks County CoC",451,13,438,788.0,
2013,PA-512,York City & County CoC,278,35,243,519.0,
2013,PA-600,"Pittsburgh, McKeesport, Penn Hills/Allegheny County CoC",1492,214,1278,582.0,
2013,PA-601,Western Pennsylvania CoC,1170,176,994,513.2777777777778,
2013,PA-603,Beaver County CoC,90,15,75,582.0,
2013,PA-605,Erie City & County CoC,435,42,393,483.0,
2013,PR-502,Puerto Rico Balance of Commonwealth CoC,2094,659,1435,440.7352941176471,
2013,PR-503,South-Southeast Puerto Rico CoC,2034,1471,563,456.4117647058824,
2013,RI-500,Rhode Island Statewide CoC,1384,251,1133,715.4999999999999,
2013,SC-500,Charleston/Low Country CoC,733,105,628,617.9047619047619,
2013,SC-501,"Greenville, Anderson, Spartanburg/Upstate CoC",2308,106,2202,546.5222222222222,
2013,SC-502,Columbia/Midlands CoC,2007,179,1828,529.734126984127,
2013,SC-503,"Myrtle Beach, Sumter City & County CoC",1496,93,1403,561.34375,
2013,SD-500,South Dakota Statewide CoC,1094,217,877,459.69214416535846,
2013,TN-500,Chattanooga/Southeast Tennessee CoC,591,102,489,460.797619047619,
2013,TN-501,Memphis/Shelby County CoC,1816,177,1639,610.0,
2013,TN-502,Knoxville/Knox County CoC,993,167,826,500.0,
2013,TN-503,Central Tennessee CoC,283,32,251,493.59940476190474,
2013,TN-504,Nashville-Davidson County CoC,2069,943,1126,631.0,
2013,TN-506,Upper Cumberland CoC,372,74,298,483.3678004535148,
2013,TN-507,Jackson/West Tennessee CoC,1673,264,1409,460.0142857142857,
2013,TN-509,Appalachian Regional CoC,694,216,478,396.73809523809524,
2013,TN-510,Murfreesboro/Rutherford County CoC,241,71,170,631.0,
2013,TN-512,"Morristown/Blount, Sevier, Campbell, Cocke Counties CoC",796,173,623,421.3363945578231,
2013,TX-500,San Antonio/Bexar County CoC,2980,621,2359,586.0,
2013,TX-503,Austin/Travis County CoC,2090,458,1632,681.0,
2013,TX-600,"Dallas City & County, Irving CoC",3163,502,2661,624.0,
2013,TX-601,"Fort Worth, Arlington/Tarrant County CoC",2390,226,2164,610.0,
2013,TX-603,El Paso City & County CoC,1217,131,1086,568.0,
2013,TX-604,Waco/McLennan County CoC,295,30,265,490.8,
2013,TX-607,Texas Balance of State CoC,10128,2022,8106,517.1369837678661,
2013,TX-624,"Wichita Falls/Wise, Palo Pinto, Wichita, Archer Counties CoC",302,86,216,503.7184523809524,
2013,TX-700,"Houston, Pasadena, Conroe/Harris, Ft. Bend, Montgomery, Counties CoC",6359,1309,5050,636.0,
2013,TX-701,"Bryan, College Station/Brazos Valley CoC",175,28,147,523.3846153846154,
2013,UT-500,Salt Lake City & County CoC,2133,313,1820,595.0,
2013,UT-503,Utah Balance of State CoC,891,119,772,533.1784722222221,
2013,UT-504,Provo/Mountainland CoC,253,22,231,630.8000000000001,
2013,VA-500,"Richmond/Henrico, Chesterfield, Hanover Counties CoC",881,58,823,786.0,
2013,VA-501,"Norfolk, Chesapeake, Suffolk/Isle of Wight, Southampton Counties CoC",742,76,666,830.6547619047619,
2013,VA-502,"Roanoke City & County, Salem CoC",442,91,351,547.6666666666666,
2013,VA-503,Virginia Beach CoC,456,93,363,918.0,
2013,VA-504,Charlottesville CoC,195,65,130,732.0075757575758,
2013,VA-505,"Newport News, Hampton/Virginia Peninsula CoC",533,112,421,918.0,
2013,VA-508,Lynchburg CoC,150,9,141,576.0,
2013,VA-513,"Harrisburg, Winchester/Western Virginia CoC",355,122,233,608.7420634920635,
2013,VA-514,"Fredericksburg/Spotsylvania, Stafford Counties CoC",192,56,136,785.0,
2013,VA-521,Virginia Balance of State CoC,715,83,632,589.6081838300587,
2013,VA-603,Alexandria CoC,275,74,201,1226.0,
2013,VT-500,Vermont Balance of State CoC,971,104,867,705.5761904761905,
2013,VT-501,Burlington/Chittenden County CoC,483,113,370,769.0,
2013,WA-500,Seattle/King County CoC,9106,869,8237,817.0,
2013,WA-501,Washington Balance of State CoC,4671,774,3897,521.2638888888889,
2013,WA-502,Spokane City & County CoC,1030,103,927,497.0,
2013,WA-503,"Tacoma, Lakewood/Pierce County CoC",1303,151,1152,643.0,
2013,WA-504,Everett/Snohomish County CoC,947,210,737,817.0,
2013,WI-500,Wisconsin Balance of State CoC,3610,258,3352,505.1026427179059,
2013,WI-501,Milwaukee City & County CoC,1442,106,1336,566.0,
2013,WI-502,Racine City & County CoC,221,11,210,575.0,
2013,WI-503,Madison/Dane County CoC,831,146,685,654.0,
2013,WV-500,"Wheeling, Weirton Area CoC",89,28,61,448.25,
2013,WV-501,"Huntington/Cabell, Wayne Counties CoC",227,46,181,400.0,
2013,WV-503,"Charleston/Kanawha, Putnam, Boone, Clay Counties CoC",411,41,370,483.3529411764706,
2013,WV-508,West Virginia Balance of State CoC,1513,317,1196,478.02190027292966,
2013,WY-500,Wyoming Statewide CoC,953,244,709,585.0835497835498,
